Grassy,none,1,0
IIIIIIIIIIIIIIIIIIIIIIIIIIIIIIIIIIIIIIIIIIIIIIIIIIIIIIIIIIIIIIIIIIIIIIIIIIIIIIIIIIIIIIIIIIIIIIIIIIIIIIIIII
I00000WWWWWWWWWWWWWWWWWWWWWWWWWWWWWWWWWWWWWWWWWWWWWWWWWWWWWWWWWWWWWW0000000000000000000000000000000000000I
I00000WRRRWCCCCW**WCCC2WRCRCRCRCRWCCCCCCCCCCCCCW1111111111111111111W0000000000000000000000000000000000000I
I00000WRRRWCCCCW**WCCCCWCRCRCRCRCWC2CCCCRCCCC2CW111RRRRRR*RRRRRR111W0000000000000000000000000000000000000I
I00000WRRRW2CCCCCCCCCCCWRCRCRCRCR*CCCCCRRRCCCCCW111R11111*11111R111W0000000000000000000000000000000000000I
I00000WRRRWWWWWWCCWWWWWWCRCRCRCRCWCCCCRRRRRCCCCW111R11111*11111R111W0000000000000000000000000000000000000I
I00000WRRRWWRRRWCCW2CC2WRCRCRCRCRWCCCCCRRRCCCCCW111R11111*11111R111W0000000000000000000000000000000000000I
I00000WRRRWRRRRRCCWCCCCWWWWWWWWWWWC2CCCCRCCCC2CW111RRRRRR*RRRRRR111W0000000000000000000000000000000000000I
I00000WRRRWRWRRWCCCCCCCWRRRC1CRRRWCCCCCCCCCCCCCW1111111111111111111W0000000000000000000000000000000000000I
I00000WRRRWWWWWWCCWCCCCCRRRC1CRRRWWWWWWWCWWWWWWWWWWWWWWWWWRRRRRRRRRW0000000000000000000000000000000000000I
I00000WRRRWCCCCWCCWCCCCCRRRC1CRRRWWWWWRRRRRWWWWWW*******WWRRRRRRRRRW0000000000000000000000000000000000000I
I00000WRRRWCCCCCCCWCCCCWRRRC1CRRRWWWRRRRCRRRRWWWCRRRRRRRCWRRRRCRRRRW0000000000000000000000000000000000000I
I00000WRRRWCCCCWCCWCCCCWRRRC1CRRRWWRCRRRRRRRCRWWCRRRRRRRCWRRRC1CRRRW0000000000000000000000000000000000000I
I00000WRRRWCCCCW2CW2CC2WRRRC1CRRRWWRRRRRLRRRRRWWCCCCCCCCCWRRRC1CRRRW0000000000000000000000000000000000000I
I00000WRRRWWWWWWWWWWWWWWRRRRCRRRRWRRRRRLLLRRRRRWWWWWCWWWWWRRRC1CRRRW0000000000000000000000000000000000000I
I00000WRRRRRRRRRRRRRRRRRRRRRRRRRRRRRRRLL1LLRRRRRRRRRRRRRRRRRRC1CRRRW0000000000000000000000000000000000000I
I00000WRRRRRRRRRRRRRRRRRRRRRRRRRRRRCRLL111LLRCRRRRRRRRRRRRRRRC1CRRRW0000000000000000000000000000000000000I
I00000WRRRWWWWWWWWWWWWWWRRRRCRRRRRRRRRLL1LLRRRRRRRRRRRRRRRRRRC1CRRRW0000000000000000000000000000000000000I
I00000WRRRWCCCCCCCCCCCCWRRRC1CRRRWRRRRRLLLRRRRRWWWWWWWWWWWRRRC1CRRRW0000000000000000000000000000000000000I
I00000WRRRWCC1C1C111C1CWRRRC1CRRRWWRRRRRLRRRRRWWCCCCCCCCCWRRRC1CRRRW0000000000000000000000000000000000000I
I00000WRRRWCC1C1CC1CC1CWRRRC1CRRRWWRCRRRRRRRCRWWCCCCCCCCCWRRRC1CRRRW0000000000000000000000000000000000000I
I00000WRRRWCC111CC1CC1CWRRRC1CRRRWWWRRRRCRRRRWWWCCCCCCCCCWRRRC1CRRRW0000000000000000000000000000000000000I
I00000WRRRWCC1C1CC1CCCCCRRRC1CRRRWWWWWRRRRRWWWWWCCCCCCCCCWRRRC1CRRRW0000000000000000000000000000000000000I
I00000WRRRWCC1C1C111C1CWRRRC1CRRRWWWWWWRWWWWWWWWCCCCCCCCCWRRRC1CRRRW0000000000000000000000000000000000000I
I00000WRRRWCCCCCCCCCCCCWRRRC1CRRRW111LL11LLL111WCCCCCCCCCCRRRC1CRRRW0000000000000000000000000000000000000I
I00000WRRRWCCCCCCCCCCCCWRRRC1CRRRW1111LL1LLLL11WCCCCCCCCCCRRRC1CRRRW0000000000000000000000000000000000000I
I00000WWWWWWWWWWWWWWWWWWRRRC1CRRRW1111LL1111LL1WCCCCCCCCCWRRRC1CRRRW0000000000000000000000000000000000000I
I000000000000000000WRRRRRRRC1CRRRW111LLL1WWLLL1WCCCCCCCCCWRRRC1CRRRW0000000000000000000000000000000000000I
I000000000000000000WRRCCCCCC1CRRRW111LLW1L11111WCCCCCCCCCWRRRC1CRRRW0000000000000000000000000000000000000I
I000000000000000000WRRRCCCCCCCRRRW1111LLLLLLLLLWCCCCCCCCCWRRRC1CRRRW0000000000000000000000000000000000000I
I000000000000000000WWRRRRRRRRRRRRW11111LLLLL11LWCCCCCCCCCWRRRC1CRRRW0000000000000000000000000000000000000I
I0000000000000000000WWRRRRRRRRRRRWWWWWWWWWWWWWWWWWWWWWWWWWRRRRCRRRRW0000000000000000000000000000000000000I
I00000000000000000000WWRRRRRRRRRRRRRRRRRRRRRRRRRRRRRRRRRRRRRRRRRRRRW0000000000000000000000000000000000000I
I000000000000000000000WWRRRRRRRRRRRRRRRRRRRRRRRRRRRRRRRRRRRRRRRRRRRW0000000000000000000000000000000000000I
I0000000000000000000000WWWRRRRRRWWWWWWWWWWWWWWWWWWWWWWWWWWWWWWWWWWWW0000000000000000000000000000000000000I
I000000000000000000000000WWRRRRWW000000000000000000000000000000000000000000000000000000000000000000000000I
I0000000000000000000000000WRRRRW0000000000000000000000000000000000000000000000000000000000000000000000000I
I0000000000000000000000000WRRRRW0000000000000000000000000000000000000000000000000000000000000000000000000I
I0000000000000000000000000WRRRRW0000000000000000000000000000000000000000000000000000000000000000000000000I
I0000000000000000000000000WRRRRW0000000000000000000000000000000000000000000000000000000000000000000000000I
I0000000000000000000000000WRRRRW0000000000000000000000000000000000000000000000000000000000000000000000000I
I0000000000000000000000000WWRRRW0000000000000000000000000000000000000000000000000000000000000000000000000I
I00000000000000000000000000WWRRW000000000000000000000IIIIIIIIIIIIIIIIIIIIIIWWWWWWWWWWWWWWWWWWWWWWWWWWWWWWI
I000000000000000000000000000WWRW000000000000000000000I111111111111111111111W1111111111111111111111111111WI
I0000000000000000000000000000WRW000000000000000000000I111111111111111111111W1111222222222222222222222111WI
I000000000000000000000000000WWRWW00000WWWWWWWWWWWWWWWI111111111111111111111W111122222222222222222222RRR1WI
I0000000000000000000000000WWWRRRWWW00WW222222222222222211111111111111111111W111122111111111111111111RLR1WI
I0000000000000000000000000WRRR11RRW0WW2222222222222222222111111111111111111WWWW1221WWWWWWWWWWWWWWW11RRR1WI
I000000000000000000000000WW1111111WWW22222222222222222222211111111111111111W11112211111111W111111W111111WI
I000000000000000000000000WC11111122W2222WWWWWWWWWWWWWI222221111111111111111111112211111111W111111W111111WI
I000000000000000000000000WRC11112222222WW000000000000I122222222222222222222222222211111111W111111WWWWWWWWI
I000000000000000000000000WRRC112222WWWWW0000000000000I112222222222222222222222222211111111W111111W222222WI
I0000000000000000000000WWWCRRC2222WW00000000000000000I112222222222222222222222222211111111W111111W222222WI
I000000000000000000000WWRC*CRRC222W000000000000000000I122221111111111111111111112211111111W1122222222222WI
I00000000000000000000WWRRRCWRRRCWWW000000000000000000I122211222222222222221W1111222222222222222222222222WI
I00000000000000000000WRRCRWWWWWWW00000000000000000000I122212222222222222221W111122222222222222211W222222WI
I00000000000000000000WRCRRWW0000000000000000000000000I122212222222222222221W11111111221111W111111W222222WI
I00000000000000000000WRRRWW00000000000000000000000000I122212222222222222221W11111111221111WWWWWWWWWWWWWWWI
I00000000000000000000WRRWW000000000000000000000000000I122212222222222222221W11111111221111WRRRWRRRRWRRRRWI
I00000000000000000000WRRW0000000000000000000000000000I122212222222222222221W11111111221111WRRRWRRRRWRRRRWI
I00000000000000000000WRRW0000000000000000000000000000I122212222222222222221W11111111221111WRRRWRRRRWRRRRWI
I00000000000000000000WRRW0000000000000000000000000000I122212222222222222221W11111122222211WRRRWRRRRWRRRRWI
I00000000000000000000WRRW0000000000000000000000000000I122212222222222222221W11111222222221WWRWWWWRWWWRWWWI
I00000000000000000000WRRW0000000000000000000000000000I122212222222222222221W11111222RR2221WRRRRRRRRRRRRRWI
I00000000000000000000WRRW0000000000000000000000000000I1222122222222222**221W1111122RRRR221WRRRRRRRRRRRRRWI
I00000000000000000000WRRW0000000000000000000000000000I1222122222222222**221W1111122RRRR221WRRRWWWRWWWRWWWI
IWWWWWWWWWWWWWWWWWWWWWRRWWWWWWWWWWWWWWWWWWWWW00000000I122212222222222222221W11111222RR2222RRRRWRRRRWRRRRWI
IWCCCCCCCCCCCCCCCCCCCCRRCCCCCCCCCCCCCCCCCCCCW00000000I122212222222222222221W11111222222222RRRRWRRRRWRRRRWI
IWCRRRRRRRRRRRRRRRRRRRRRRRRRRRRRRRRRRRRRRRRCW00000000I122212222222222222221W11111122222211WRRRWRRRRWRRRRWI
IWCRCRRRCRRRCRRRCRRRCRCCRCRRRCRRRCRRRCRRRCRCW00000000I122212222222222222221WWWWWW111221111WRRRWRRRRWRRRRWI
IWCRRRRRRRRRRRRRRRRRRRRRRRRRRRRRRRRRRRRRRRRCW00000000I122212222222222222221WRRRRW111221111WWWWWWWWWWWWWWWI
IWCRRRCCCCCCCCCCCCCCCCRRCCCCCCCCCCCCCCCCRRRCW00000000I122212222222222222221WRRRRR2222211111111111WRRRRRRWI
IWCRRRCRRRRRRRRRRRRRRCRRCRRRRRRRRRRRRRRCRRRCW00000000I122212222222222222221WRRRRW1112211112222222RRRRRRRWI
IWCRCRCRRRRRRRRRRRRRRCRRCRRRRRRRRRRRRRRCRCRCW00000000I122212222222222222221WRRRRW1112211122211111WRRRRRRWI
IWCRRRCRRRRRRRRRRRRRRCRRCRRRRRRRRRRRRRRCRRRCW00000000I122211222222222222221WWWWWW1112222222111111WRRRRRRWI
IWCRRRCRRRWWWWWWWWWWWWRRWWWWWWWWWWWWRRRCRRRCW00000000I1222111111111111111111111111112222222111111WWWWWWWWI
IWCRRRCRRRWCCCCCCCCCCWRRWCCCCCCPCCLWRRRCRRRCW00000000I1222222222222222222222222222222211122211111WRRRRRRWI
IWCRCRCRRRWCCCCCCCCCCWRRWLLLLLLCLCLWRRRCRCRCW00000000I1122222222222222222222222222222211112222222RRRRRRRWI
IWCRRRCRRRWCCCCCCCCCCWRRWLCCCCLCLCLWRRRCRRRCW00000000I1111222222222222222111111111111111111111111WRRRRRRWI
IWCRRRCRRRWCCCCCCCCCCWRRWLLLLCLCLCLWRRRCRRRCW00000000I111111111111111111111W111111111111111111111WRRRRRRWI
IWCRRRCRRRWCCCCCCCWWWWRRWWWWLCLCLCLWRRRCRRRCW00000000I111111111111111111111WWWWWWWWWWWWWWWWWWWWWWWWWWWWWWI
IWCRCRCRRRWCCCCCCCWRRRRRRRRWLCLCLPCWRRRCRCRCW00000000I111111111111111111111111111111111111111111111111111I
IWCRRRCRRRWCCCCCCCCRRRRRRRRCCCLCLLLWRRRCRRRCW00000000I111111111111111111111111111111111111111111111111111I
IWCRRRCRRRWCCCCCCCWRRR1RRRRWLCLCPCLWRRRCRRRCW00000000I111111111111111111111111111111111111111111111111111I
IWCRRRCRRRWCCCCCCCWRRRRRRRRWLCLLLCLWRRRCRRRCW00000000I111111111111111111111111111111111111111111111111111I
IWCRCRCRRRWCCCCCCCWRRRRRRRRWLCCCLCLWRRRCRCRCW00000000I111111111111111111111111111111111111111111111111111I
IWCRRRCRRRWCCCCCCCWWWWWCWWWWLLLCLCLWRRRCRRRCW00000000I11111111111111111111111111111111111111111111W111111I
IWCRRRCRRRWCCCCCCWCCCCCCCCCWWWLCPCLWRRRCRRRCW00000000I1111111111111111111111111111111111111111111WWW11111I
IWCRRRCRRRWCCCCWWCCCCCCCCCCCCWLLLLLWRRRCRRRCW00000000I111111111111111111111111111111111111111111WW2WW1111I
IWCRCRCRRRWCCCCWWCCCCCCCCCCCCWWWLLLWRRRCRCRCW00000000I11111111111111111111111111111111111111111*RR22WW111I
IWCRRRCRRRWCCCCCWCCCCCCCCCCCCRRRRRRWRRRCRRRCW00000000I1111111111111111111111111111111111111111WR2RRRRWW11I
IWCRRRCRRRWCCCCCWCCCCCCCCCCCCWRRRRRWRRRCRRRCW00000000I111111111111111111111111111111111111111WWRRR22RRWW1I
IWCRRRCRRRWCCCCCW************WRRRRRWRRRCRRRCW00000000I11111111111111111111111111111111111111WWRR2RR22R2WWI
IWCRCRCRRRWCCCCCWWWWWWWWWWWWWWRRRRWWRRRCRCRCW00000000I111111111111111111111111111111111111111WWR22RRRRWW1I
IWCRRRCRRRWWWWWWWWWWWWWWWWWWWWWWWWWWRRRCRRRCW00000000I1111111111111111111111111111111111111111WWR2RR2WW11I
IWCRRRCRRRRRRRRRRRRRRRRRRRRRRRRRRRRRRRRCRRRCW00000000I11111111111111111111111111111111111111111WWWRWWW111I
IWCRRRCRRRRRRRRRRRRRRRRRRRRRRRRRRRRRRRRCRRRCW00000000I111111111111111111111111111111111111111111WWRWW1111I
IWCRCRCRRRRRRRRRRRRRRRRRRRRRRRRRRRRRRRRCRCRCW00000000I1111111111111111111111111111111111111111111WWW11111I
IWCRRRCCCCCCCCCCCCCCCCCCCCCCCCCCCCCCCCCCRRRCW00000000I11111111111111111111111111111111111111111111W111111I
IWCRRRRRRRRRRRRRRRRRRRRRRRRRRRRRRRRRRRRRRRRCW00000000I111111111111111111111111111111111111111111111111111I
IWCRCRRCRRRCRRRCRRRCRRRCRRRCRRRCRRRCRRRRRCRCW00000000I111111111111111111111111111111111111111111111111111I
IWCRRRRRRRRRRRRRRRRRRRRRRRRRRRRRRRRRRRRRRRRCW00000000I111111111111111111111111111111111111111111111111111I
IWCCCCCCCCCCCCCCCCCCCCCCCCCCCCCCCCCCCCCCCCCCW00000000I111111111111111111111111111111111111111111111111111I
IWWWWWWWWWWWWWWWWWWWWWWWWWWWWWWWWWWWWWWWWWWWW00000000I111111111111111111111111111111111111111111111111111I
IIIIIIIIIIIIIIIIIIIIIIIIIIIIIIIIIIIIIIIIIIIIIIIIIIIIIIIIIIIIIIIIIIIIIIIIIIIIIIIIIIIIIIIIIIIIIIIIIIIIIIIIII
