Volcano                           
IIIIIIIIIIIIIIIIIIIIIIIIIIIIIIIIII
IWWWWWWWWWWWWWWWWWWWWWWWWWWWWWWWWI
IWRRRRRRRRRRRRRRRRRRRRRRRRRRRRRRWI
IWRRRRRRRRRRRRRRRRRRRRRRRRRRRRRRWI
IWRRRRRRRRRRRRRRRRRRRRRRRRRRRRRRWI
IWRRRRRRRRRRRRRRRRRRRRRRRRRRRRRRWI
IWRRRRRRRRRRRRRRRRRRRRRRRRRRRRRRWI
IWRRRRRRRRRRRRRRRRRRRRRRRRRRRRRRWI
IWRRRRRRRRRRRRRRRRRRRRRRRRRRRRRRWI
IWRRRRRRRRRRRRRRRRRRRRRRRRRRRRRRWI
IWRRRRRRRRRRRRRRRRRRRRRRRRRRRRRRWI
IWRRRRRRRRRRRRRRRRRRRRRRRRRRRRRRWI
IWRRRRRRRRRRRRRRRRRRRRRRRRRRRRRRWI
IWRRRRRRRRRRRRRRRRRRRRRRRRRRRRRRWI
IWRRRRRRRRRRRRRRRRRRRRRRRRRRRRRRWI
IWRRRRRRRRRRRRRCCCCRRRRRRRRRRRRRWI
IWRRRRRRRRRRRRRCCCCRRRRRRRRRRRRRWI
IWRRRRRRRRRRRRRCCCCRRRRRRRRRRRRRWI
IWRRRRRRRRRRRRRCCCCRRRRRRRRRRRRRWI
IWRRRRRRRRRRRRRRRRRRRRRRRRRRRRRRWI
IWRRRRRRRRRRRRRRRRRRRRRRRRRRRRRRWI
IWRRRRRRRRRRRRRRRRRRRRRRRRRRRRRRWI
IWRRRRRRRRRRRRRRRRRRRRRRRRRRRRRRWI
IWRRRRRRRRRRRRRRRRRRRRRRRRRRRRRRWI
IWRRRRRRRRRRRRRRRRRRRRRRRRRRRRRRWI
IWRRRRRRRRRRRRRRRRRRRRRRRRRRRRRRWI
IWRRRRRRRRRRRRRRRRRRRRRRRRRRRRRRWI
IWRRRRRRRRRRRRRRRRRRRRRRRRRRRRRRWI
IWRRRRRRRRRRRRRRRRRRRRRRRRRRRRRRWI
IWRRRRRRRRRRRRRRRRRRRRRRRRRRRRRRWI
IWRRRRRRRRRRRRRRRRRRRRRRRRRRRRRRWI
IWRRRRRRRRRRRRRRRRRRRRRRRRRRRRRRWI
IWWWWWWWWWWWWWWWWWWWWWWWWWWWWWWWWI
IIIIIIIIIIIIIIIIIIIIIIIIIIIIIIIIII
