Desert              
WWWWWWWWWWWWWWWWWWWW
W111111111111111111W
W111111111111111111W
W111111111111111111W
W111111111111111111W
W111111111111111111W
W111111111111111111W
WO11111111111111111W
WWPRC*>2L1111111111W
W111111111111111111W
W111111111111111111W
W111111111111111111W
W111111111111111111W
W111111111111111111W
W111111111111111111W
W111111111111111111W
W111111111111111111W
W111111111111111111W
W111111111111111111W
WWWWWWWWWWWWWWWWWWWW
