Grassy,none,1
IIIIIIIIIIIIIIII
IWWWWWWWWWWWWWWI
IWRRRRRRWRRRRRWI
IWRRWRRRWRRWRRWI
IWRRWWWWWWWWRRWI
IWRRRRRRWRRRRRWI
IWRRRWWWWWWWRRWI
IWRRRRRRWRRRRRWI
IWRRRRRRWRRRRRWI
IWRRRRRRWRRRRRWI
IWWWWRWWWWWRWWWI
IIIIIIIIIIIIIIII
