Desert,none,1,0
IIIIIIIIIIIIIIIIIIIIIIIIIIIIIIIIIIIIIIIIII
I11111111111111WWWWRRRLLLLRRRRR1111111111I
IP1111111111111WWWWRRRLLLLRRRRRRRRRR11111I
IPP111111111111WWWWWRRLLLLWWWWWWWWWRR1111I
IPPP11111111111WWWWWLLLLLLLWWWWWWWWWRRR11I
IPPPP111111111WWWWWWLLLLLLL11WWWWWWWWWR11I
I1PPP111111111WWWWWLLLLLLLL111111WWWWW111I
I11PPP1111111WWWWWWLLLLLLL111111111111111I
I111PP1111111WWWWWLLLLL111111111111111111I
I111111111111WWWWWLLL1111111111RRRRR11111I
I11111111111WWWWW1LLL111111111RRWWWR11111I
I1111111111WWWWWW1LLL11111111RRWWWWR11111I
I111111111WWWWWW11LLL1111111RRWWWWRR11111I
I11111111WWWWWW111LLL111111RRWWWWRR111111I
I1111111WWWWWWW11LLLL111111RWWWWRR1111111I
I111111WWWWWWW11LLLLL111111RWWRRR11111111I
I11111WWWWWWWW11LLLL1111111RRRR1111111111I
I11111WWWWWWWLLLLLL1111111111111111111111I
I1111WWWWWWWLLLLL111111111111111111111111I
I11111WWWWWWLLL11111111111111111111111111I
I111111WWW111111111111111P111111111111111I
I11111111111111111111111PPP11111111111111I
I1111111111111111111111PPPP11111111111111I
I11111111111111111111PPPPP111111111111111I
I1111111111111111111PPPPP1111111111111111I
IW11111111111111111PPPPP11111111111111111I
IWWW111111111111111PPP11111111WWWWW111111I
IWWWW1111111111111111111111111WWWWWWWWW11I
IWWWWWW1111111111111111111111111WWWWWWWWWI
IWWWWWWW1111111111111111111111111WWWWWWWWI
IWWWWWRR111111111111111111111111111WWWW11I
IWWWWWRWWW1111111111111111111111111111111I
IWWWWWRRRWW11111111111111111WW11111111111I
IWWWWWWRRWWWW1111111111WWWWWWW11111111111I
I11WWWWWWWWWWW11111111WWWWWWWW11111111111I
I111WWWWWWWWWW1111111WWWWWWWW111111111111I
I11111WWWWWWWWW11111WWWWWW111111111111111I
I1111111WWWWWWW11111WWWW11111111111111111I
IRR111111111WWWW111WWWW111111111111111111I
IWRRR11111111111111WWWW11111111RRRRR11111I
IWWWRR111111111111WWWW11111111RRWWWRR1111I
IWWWWRR11111111111WWW11111111RRWWWWWRR111I
IIIIIIIIIIIIIIIIIIIIIIIIIIIIIIIIIIIIIIIIII
