Desert,none,1,0
IIIIIIIIIIIIIIIIIIIIII
I1111111111111RRRRWWWI
I11111111111111RRRRWWI
I111111111111111RRRRWI
ILL11111111111111RRRRI
ILLL11111111111111RRRI
ILLL1111111111111111RI
ILL111111111111111111I
IL1111111111111111111I
I11111111111111111111I
I11111111111111111111I
I11111111111111111111I
I11111111111111111111I
I11111111111111111111I
I11111111111111111111I
I11111111111111111111I
I11111111111111111111I
I11111111111111111111I
I11111111111111111111I
I11111111111111111111I
I11111111111111111111I
IIIIIIIIIIIIIIIIIIIIII
