Island                                    
IIIIIIIIIIIIIIIIIIIIIIIIIIIIIIIIIIIIIIIIII
ILLLLLLLLLLLLLLLLLLLLLLLLLLLLLLLLLLLLLLLLI
ILLLLLLLLLLLLLLLLLLLLLLLLLLLLLLLLLLLLLLLLI
ILLLLLLLLLLLLLLLLLLLLLLLLLLLLLLLLLLLLLLLLI
ILLLL2222LLLLLLLLLLLLLLLLLLLLLLLLLLLLLLLLI
ILLL222222LLLLLLLLLLCCLLLLLLLL2222LLLLLLLI
ILLL222222LLLLLLLLLLCCLLLLLLL2222222LLLLLI
ILL2211112222LLLLLLLCCLLLLLLL22211222LLLLI
ILL2211111222222LLLLCCLLLLLL222111122LLLLI
ILL22111111122222222CC2222222111111222LLLI
ILL22111111111122222CC2222221111111122LLLI
ILL22111111111111111O11111111111111122LLLI
ILL221111111111111111111111111111111222LLI
ILL22111111111111111111111111111111122LLLI
ILL211111111111111WWCCWW11111111111122LLLI
ILL211111111111111WCCCCW11111111111122LLLI
ILL211111111111111WCCCCW1111111111112LLLLI
ILL211111111111111WCCCCW1111111111112LLLLI
ILL211111111111111WCCCCW11111111111122LLLI
ILL211111111111111WWWWWW11111111111122LLLI
ILL211111111111111111111111111111111122LLI
ILL211111111111111111111111111111111112LLI
ILL2111111111111111111111111111111111122LI
ILL2111111111111111111111111111111111122LI
ILL211111111111111111111RRRR11111111112LLI
IL221111111111111111111R***R11111111122LLI
IL21111111111111111111RR**R11111111112LLLI
IL21111111111111111111RR*RR11111111112LLLI
IL2211111111111111111111RR111111111122LLLI
IL221111111111111111111111111111111222LLLI
ILL2211111111111111111111111111111222LLLLI
ILL2211111111111111111111111111122222LLLLI
ILL2221111111111111111111111112222222LLLLI
ILLL22111111111111111111111112222222LLLLLI
ILLL222211111111111111111112222222LLLLLLLI
ILLLL22221111111111222222222222222LLLLLLLI
ILLLLL222222111112222222222222222LLLLLLLLI
ILLLLLLLL22222222222LLLLL22222222LLLLLLLLI
ILLLLLLLLL2222222LLLLLLLLLL2222LLLLLLLLLLI
ILLLLLLLLLLLLLLLLLLLLLLLLLLLLLLLLLLLLLLLLI
ILLLLLLLLLLLLLLLLLLLLLLLLLLLLLLLLLLLLLLLLI
IIIIIIIIIIIIIIIIIIIIIIIIIIIIIIIIIIIIIIIIII
