0000000000WPPPPPPPPPPPPPPPPPPPPPPPPPPPPPPPPPPPPPPPPPPPPPPPPPPPPPPPPPPPPPPPPPPPPPPPPPPPPPPPPPPPPPPPPPPPPPPPPPPPP
0000000000WPPPPPPPPPPPPPPPPPPPPPPPPPPPPPPPPPPPPPPPPPPPPPPPPPPPPPPPPPPPPPPPPPPPPPPPPPPPPPPPPPPPPPPPPPPPPPPPPPPPP
0000000000WPPPPPPPPPPPPPPPPPPPPPPPPPPPPPPPPPPPPPPPPPPPPPPPPPPPPPPPPPPPPPPPPPPPPPPPPPPPPPPPPPPPPPPPPPPPPPPPPPPPP
0000000000WPPPPPPPPPPPPPPPPPPPPPPPPPPPPPPPPPPPPPPPPPPPPPPPPPPPPPPPPPPPPPPPPPPPPPPPPPPPPPPPPPPPPPPPPPPPPPPPPPPPP
0000000000WPPPPPPPPPPPPPPPPPPPPPPPPPPPPPPPPPPPPPPPPPPPPPPPPPPPPPPPPPPPPPPPPPPPPPPPPPPPPPPPPPPPPPPPPPPPPPPPPPPPP
0000000000WPPPPPPPPPPPPPPPPPPPPPPPPPPPPPPPPPPPPPPPPPPPPPPPPPPPPPPPPPPPPPPPPPPPPPPPPPPPPPPPPPPPPPPPPPPPPPPPPPPPP
0000000000WPPPPPPPPPPPPPPPPPPPPPPPPPPPPPPPPPPPPPPPPPPPPPPPPPPPPPPPPPPPPPPPPPPPPPPPPPPPPPPPPPPPPPPPPPPPPPPPPPPPP
0000000000WPPPPPPPPPPPPPPPPPPPPPPPPPPPPPPPPPPPPPPPPPPPPPPPPPPPPPPPPPPPPPPPPPPPPPPPPPPPPPPPPPPPPPPPPPPPPPPPPPPPP
0000000000WPPPPPPPPPPPPPPPPPPPPPPPPPPPPPPPPPPPPPPPPPPPPPPPPPPPPPPPPPPPPPPPPPPPPPPPPPPPPPPPPPPPPPPPPPPPPPPPPPPPP
0000000000WPPPPPPPPPPPPPPPPPPPPPPPPPPPPPPPPPPPPPPPPPPPPPPPPPPPPPPPPPPPPPPPPPPPPPPPPPPPPPPPPPPPPPPPPPPPPPPPPPPPP
0000000000WPPPPPPPPPPPPPPPPPPPPPPPPPPPPPPPPPPPPPPPPPPPPPPPPPPPPPPPPPPPPPPPPPPPPPPPPPPPPPPPPPPPPPPPPPPPPPPPPPPPP
0000000000WPPPPPPPPPPPPPPPPPPPPPPPPPPPPPPPPPPPPPPPPPPPPPPPPPPPPPPPPPPPPPPPPPPPPPPPPPPPPPPPPPPPPPPPPPPPPPPPPPPPP
0000000000WPPPPPPPPWWWWWWWWWWWWWWWWWWWWWWWWWWWWWWWWWWWWWWWWWWWWWWWWWWWWWWWWWWWWWWWWPPPPPPPPPPPPPPPPPPPPPPPPPPPP
0000000000WPPPPPPPPWRRRRRRRRRRRRRRRRRW1RRRR****RRRRRRRRRRRRRRRRRRRRRRRWRRRRRRRR1W1WPPPPPPPPPPPPPPPPPPPPPPPPPPPP
0000000WWWWPPPPPPPPWRRRRRRRRRRRRRRRRRWPPPPPPPPPWRWWWWWWWWWWRWWWWWWWWRRWRWWWWWWWWWRWPPPPPPPPPPPPPPPPPPPPPPPPPPPP
0000000WRRWWWWWWWWWWRRRRRRRRRRRRRRRRRWWWWWWWWWWWRWPPPPPPPPWRWPPPPPPRRRPRRRRRRRRRWRWPPPPPPPPPPPPPPPPPPPPPPPPPPPP
0000000WRRPPPPPPPPPPRRRRRRRRORRRRRRRRRRRRRRRRRRRRWWWWWWWWWWRWPPPPPRRRPPRWWWWWWWWWRWPPPPPPPPPPPPPPPPPPPPPPPPPPPP
0000000WRRWWWWWWWWWW>RRRRRRRRRRRRRRRRWWWWWWWWWWWRWPPPPPPPPWRWPPPPRRRPPPRRRRRRRRRWRWPPPPPPPPPPPPPPPPPPPPPPPPPPPP
0000000WWWWPPPPPPPPWRRRRRRRRRRRRRRRRRWPPPPP1PPPWRWWWWWWWWWWRWPPPW1WPPPPRWWWWWWWWWRWPPPPPPPPPPPPPPPPPPPPPPPPPPPP
0000000000WPPPPPPPPWRRRRRRRRRRRRRRRRRWPPPPPRPPPWRRRRRRRRRRRRWPPPWWWPPPPRRRRRRRRRRRWPPPPPPPPPPPPPPPPPPPPPPPPPPPP
0000000000WPPPPPPPPWWWWWWWWWWWWWWWWWWWPPPPPRPPPWRWWWWWWWWWWWWWWWWWWWWWWRWWWWWWRWWWWPPPPPPPPPPPPPPPPPPPPPPPPPPPP
0000000000WPPPPPPPPW1WRRRRRRRRRRRRRRRWPPPPPRPPPWRRRRRRRRRRRRRRRRRRRRRRRRWPP1RRRRP1PPPPPPPPPPPPPPPPPPPPPPPPPPPPP
0000000000WPPPPPPPPWRWRRRRRRRRRRRRRRRWWWWPPRPPPWWWWWWWWWWWWWWWWWWWWWWWWRWPPPPPPPP*PPPPPPPPPPPPPPPPPPPPPPPPPPPPP
0000000000WPPPPPPPPWRRRRRRRRRRRRRRRRRRRRRRRRRRRRRRRRRRRRRRRRRRRRRRRRRRRRWPPPPPPPPRPPPPPPPPPPPPPPPPPPPPPPPPPPPPP
0000000000WPPPPPPPPWRRRRRRRRRRRRRRRRRWWWWWWWWWWWWWWWWWWWWWWWWWWWWWWWWWWRWPPPPPPPPRPPPPPPPPPPPPPPPPPPPPPPPPPPPPP
0000000000WPPPPPPPPWRRRRRRRRRRRRRRRRRRRRR1PPPPPPPPPPPPPPPPPPPPPPPPPPPPPRWPPPPPPPPRPPPPPPPPPPPPPPPPPPPPPPPPPPPPP
0000000000WPPPPPPPPWWWWWWWWWWWWWWWWWWWPPPPPPPPPPPPPPPPPPPPPPPPPPPPPPPPPRWPPPPPPPPRPPPPPPPPPPPPPPPPPPPPPPPPPPPPP
0000000000WPPPPPPPPPPPPPPPPPPPPPPPPPPPPPPPPPPPPPPPPPPPPPPPPPPPPPPPPPRRRRWPPPPPPPPRPPPPPPPPPPPPPPPPPPPPPPPPPPPPP
0000000000WPPPPPPPPPPPPPPPPPPPPPPPPPPPPPPPPPRRRRRRRRRRRRRRRRRRRRR1PPRRRRWPPPPPPPPRPPPPPPPPPPPPPPPPPPPPPPPPPPPPP
0000000000WPPPPPPPPPPPPPPPPPPPPPPPPPPPPPPPPPPPPPPPPPPRPPPPPPPPPPPPPPRRRRWPPPPPPPPRPPPPPPPPPPPPPPPPPPPPPPPPPPPPP
0000000000WPPPPPPPPPPPPPPPPPPPPPPPPPPPPPPPPPPPPPPPPPPRRRRRRRRRRRRRRRRRRRRRRRRRRRRRPPPPPPPPPPPPPPPPPPPPPPPPPPPPP
0000000000WPPPPPPPPPPPPPPPPPPPPPPPPPPPPPPPPPPPPPPPPPPPPPPPPPPPPPPPRPPPPPPPPPPPPPPPPPPPPPPPPPPPPPPPPPPPPPPPPPPPP
0000000000WPPPPPPPPPPPPPPPPPPPPPPPPPPPPPPPPPPPPPPPPPPPPPPPPPPPPPPPRPPPPPPPPPPPPPPPPPPPPPPPPPPPPPPPPPPPPPPPPPPPP
0000000000WPPPPPPPPPPPPPPPPPPPPPPPPPPPPPPPPPPPPPPPPPPPPPPPPPPPPPPPRPPPPPPPPPPPPPPPPPPPPPPPPPPPPPPPPPPPPPPPPPPPP
0000000000WPPPPPPPPPPPPPPPPPPPPPPPPPPPPPPPPPPPPPPPPPPPPPPPPPPPPPPPRPPPPPPPPPPPPPPPPPPPPPPPPPPPPPPPPPPPPPPPPPPPP
0000000000WPPPPPPPPPPPPPPPPPPPPPPPPPPPPPPPPPPPPPPPPPPPPPPPPPPPPPPPPPPPPPPPPPPPPPPPPPPPPPPPPPPPPPPPPPPPPPPPPPPPP
0000000000WPPPPPPPPPPPPPPPPPPPPPPPPPPPPPPPPPPPPPPPPPPPPPPPPPPPPPPPPPPPPPPPPPPPPPPPPPPPPPPPPPPPPPPPPPPPPPPPPPPPP
0000000000WPPPPPPPPPPPPPPPPPPPPPPPPPPPPPPPPPPPPPPPPPPPPPPPPPPPPPPPPPPPPPPPPPPPPPPPPPPPPPPPPPPPPPPPPPPPPPPPPPPPP
0000000000WPPPPPPPPPPPPPPPPPPPPPPPPPPPPPPPPPPPPPPPPPPPPPPPPPPPPPPPPPPPPPPPPPPPPPPPPPPPPPPPPPPPPPPPPPPPPPPPPPPPP
0000000000WPPPPPPPPPPPPPPPPPPPPPPPPPPPPPPPPPPPPPPPPPPPPPPPPPPPPPPPPPPPPPPPPPPPPPPPPPPPPPPPPPPPPPPPPPPPPPPPPPPPP
0000000000WPPPPPPPPPPPPPPPPPPPPPPPPPPPPPPPPPPPPPPPPPPPPPPPPPPPPPPPPPPPPPPPPPPPPPPPPPPPPPPPPPPPPPPPPPPPPPPPPPPPP
0000000000WPPPPPPPPPPPPPPPPPPPPPPPPPPPPPPPPPPPPPPPPPPPPPPPPPPPPPPPPPPPPPPPPPPPPPPPPPPPPPPPPPPPPPPPPPPPPPPPPPPPP
0000000000WPPPPPPPPPPPPPPPPPPPPPPPPPPPPPPPPPPPPPPPPPPPPPPPPPPPPPPPPPPPPPPPPPPPPPPPPPPPPPPPPPPPPPPPPPPPPPPPPPPPP
0000000000WPPPPPPPPPPPPPPPPPPPPPPPPPPPPPPPPPPPPPPPPPPPPPPPPPPPPPPPPPPPPPPPPPPPPPPPPPPPPPPPPPPPPPPPPPPPPPPPPPPPP
0000000000WPPPPPPPPPPPPPPPPPPPPPPPPPPPPPPPPPPPPPPPPPPPPPPPPPPPPPPPPPPPPPPPPPPPPPPPPPPPPPPPPPPPPPPPPPPPPPPPPPPPP