1111PPPPPPPPPPPPPPPWWWWWW
1111PPPPPPPPPPPPPPPWCCCCW
1111PPPPPPPPPPPPPPPWCCCCW
1111PPPPPPPPPPPPPPPWCCCCW
1111PPPPPPPPPWWWWWPWCCCCW
1111PPPPPPPPPWCCCWPWCW>OW
1111PPPPPPPPPWCCCWPWCWWWW
1111PPPPPPPPPWCCCWPWCWRRW
1111PPPPPPPPPWCCCWPWCWW*W
1111PPPPPPPPPWCCCWPWCWWPW
1111PPPPPPPPPWCCCWWWCWW*W
1111PPPPPPPPPW1CCCCWCWWCW
1111PPPPPPPPPW1WWWCCCCCCW
1111PPPPPPPPPW1WWWCCCCCCW
1111PPPPPPPPPW1WWWWWWWWPW
1111PPPPPPPPPW1WWWWWWWW*W
1111PPPPPPPPPW1WWWWWWWWCW
1111PPPPPPPPPW1WWWWWWWWCW
1111PPPPPPPWWW1WWWWWWWWCW
1111PPPPPPPWCCCCWWWWWWWCW
1111PPPPPPPWCCCCWWWWWWWCW
1111PPPPPPPW>CCCWWWWWWWCW
1111PPPPPPPWWWWWWWWWWWWCW
1111PPPPPPPPPPPPWW>CCCCCW
1111PPPPPPPPPPPPWWWWWWWWW
