WWWWWWWWWW
WCCWCCCCCW
WCCWCCCCCW
WCCWCCCCCW
WCCWWCW>OW
W1C111WWWW
W1WW11*CCW
W11WWWWCCW
W>1WRRPCCW
WWWWWWWWWW
