WWWWWWWWWWWWWWWWWWWWWWWWWWWWWWWWWWWWWWWWWWWWWWWWWWW
W1111111111W11W111111111111WWWWWW11111111111111111W
W1111WW1111W1WWWW111W111111RRRRRW111111111WWW11111W
W1111RR1111W1W1W11111111111WWWWRW111111111W>W11111W
W1W11111111WWW1111W111W1111111WRW111111W11W1W11111W
W1111111W11W1WWW11111111111111WWW11111111111111111W
W1111111111W1W111111W11111111111111111111111111111W
W111W111111W11111111111111111111111111111111111111W
W1111111111W11111111111111111111111111111111111111W
W1111111W11WWWWWWWWCWWWWWWWWWWWWWWWWWWWWWWWWWWWCWWW
W111W111111WCCCCCWCCCWCCCCCCCCCCCCCWCCCCCCCCCCCCCCW
W1111111111WCCCCCWCCCWCCCCCCCCCCCCCWCCCCCCCCCCCCCCW
W1W111111W1WCCCCCCCCCWCCCCCCCCCCCCCWCCCCCCCCCCCCCCW
W1111111111WCCCCCWCCCWCCCCCCCCCCCCCWCCCCCCCCCCCCCCW
W1111111W11WCCCCCWCCCWCCCCCCCCCCCCCWCCCCCCCCCCCCCCW
W1111111111WWWWWWWCCCWWWWCWWWWWWWWWWWWWWWWCWWWWWWWW
W11W1111111WCCCCCWCCCCCCCCCCCCCCCCCCWCCCCCCCCCCCCCW
W1111111111WCCCCCCCCCCCCCCCCCCCCCCCCCCCCCCCCCCCCCCW
W111111111WWCCCCCWCCCCCCCCCCCCCCCCCCWCCCCCCCCCCCCCW
W*WWWWWWWWWWWWWWWWWWWWCWWWWWWWWCCCCCWWWWWWWWWWWWWWW
WRWW1111111WCCCCCCCCCCCCWCCCCCWCCCCCWCCCCCCWCCCCCCW
WRR*1111111WCCCCCCCCCCCCWCCCCCWCCCCCWCCCCCCWCCCCCCW
WWWW1111111WCCCCCCCCCCCCW*****WCCCCCWCCCCCCWCCCCCCW
W1111111111WCCCCCCCCCCCCWCCCCCWCCCCCWCCC>CC*CCCCCCW
W1111111111WCCCCCCCCCCCCWCCCCCWCCCCCWCCCCCC*CCCCCCW
W1111111111WCCCWWWWWWCCCWCCCCCWCCCCCWCCCCCCWCCCCCCW
W1111111111WCCCWWWWWWCCCWCCCCCWCCCCCWCCCCCCWCCCCCCW
W1111111111WCCCWWWWWWCCCCCCCCCWCCCCCWCCCCCCWCCCCCCW
W1111111111WCCCCCCCCCCCCWCCCCCWCCCCCWWWWWWWWWWWCWWW
W1111111111WCCCCCCCCCCCCWCCCCCWCCCCCWWWCC***CCWCWWW
W1111111111WCCCCCCCCCCCCWCCCCCWCCCCCWCCCCCCCCCCCCCW
WWWCWWWWWWWWWWWWWWWWWWWWWWWWWWWCCCCCWCCCCCCCCCCCCCW
WCCCWCWW*C*WCCCCCCCCCCCCCCCCCCWCCCCCWCCCCCCCCCCCCCW
WCCCCCCCCCCWCCCCCCCCCCCCCCCCCCWCCCCCWCCCCCCCCCCCCCW
WCCCCCCCCCCWCCCCCCCCCCCCCCCCCCWCCCCCWCCCRCCCCCRCCCW
WCCCCCCCCCCWCCCCCCCCCCCCCCCCCCWCCCCCWCCRRRCCCRRRCCW
WCCCCCCCCCCWCCCCCWWWWWWWWWCCCCWCCCCCWCRRRRRCRRRRRCW
WCCCCCCCCCCWCCCCCWWWWWWWWWCCCCWCCCCCWCCRRRCCCRRRCCW
WCCCCCCCCCCCCCCCCWWWWWWWWWCCCCCCCCCCCCCCRCCCCCRCCCW
WCCCCCCCCCCWCCCCCWWWWWWWWWCCCCWCCCCCWCCCCCCCCCCCCCW
WCCCCCCCCCCWCCCCCCCCCCCCCCCCCCWCCCCCWCCCCCCCCCCCCCW
WCCCCCCCCCCWCCCCCCCCCCCCCCCCCCWCCCCCWCCCCCCCCCCCCCW
WCCCCCCCCCCWCCCCCCCCCCCCCCCCCCWCCCCCWCCCCCCCCCCCCCW
WWWWWWWWWWWWWWWWWWWWWWWWWWWWWWWCCCCCWWWWWWWWWWWWWWW
WCCCCCCCCCCWCCCCCCCCCCCCCCCCCCCCCCCCCCCCCCCWCCCCCCW
WCCCCCCCCCCCCCCCCCCCCCCCCCCCCCCCCCCCCCCCCCCCCCCCCCW
WCCCCCCCCCCWCCCCCCCCCCCCCCCCCCCCCCCCCCCCCCCWCCCCCCW
WWWWWCWWWWWWWWWWWWWWWWWWWCCWWWWWWWWWCWWWWWWWWWWWWWW
WCCCCCCCCCC*CCCCCCCCWCCCCCCCCCCWCCCCCCCCCCWCCCCCCCW
WCCCCCCCCCCWCCCCCCCCWCWWWCCWWWCWCCPWWWWPCCWCCCCCCCW
WCCCCCCCCCCWCCCCCCCCWCWCCCCCCWCWCCWRRRRWCCCCCCCCCCW
WCCCCCCCCCCWCCCC>CCCWCWCCRRCCWCWCCWRRRRWCCCCCCCCCCW
WCCCCCCCCCCWCCCCCCCCWCCCCRRCCCCWCCPWWWWPCCWCCCCCCCW
WCCCCCCCCCCWCCCCCCCCWCCCCCCCCCCWCCCCCCCCCCWCCCCCCCW
WWWWWWWWWWWWWWWWWWWWWWWWWCCWWWWWWWWWWWWWWWWWWWWWWWW
11111111111111111W1111111111111111W1111111111111111
11111111111111111W1111111111111111W1111111111111111
11111111111111111W1111111111111111W1111111111111111
11111111111111111W1111111111111111W1111111111111111
11111111111111111W1111111111111111W1111111111111111
11111111111111111W1111111111111111W1111111111111111
11111111111111111W1111111111111111W1111111111111111
11111111111111111W1O11111111111111W1111111111111111
11111111111111111W1111111111111111W1111111111111111
11111111111111111WWWWWWWWWWWWWWWWWW1111111111111111
