WWWWWWWWWWWWWWWWWWWW0000000000000000000000000000000000000WWWWWWWWWWWWWWWWWWWW
W111111111111111111WWWWWWWWWWWWWWWWWWWWWWWWWWWWWWWWWWWWWWW111111111111111111W
W111111111111111111***************************************1111111111111111>1W
W111111111111111111WWWWWWWWWWWWWWWWWWWWWWWWWWWWWWWWWWWWWWW111111111111111111W
W111111111111111111W0000000000000000000000000000000000000W1111111111O1111111W
W111111111111111111W0000000000000000000000000000000000000W111111111111111111W
W111111111111111111WWWWWWWWWWWWWWWWWWWWWWWWWWWWWWWWWWWWWWW111111111111111111W
W111111111111111111111111PP11RRRW0WCCCCCCCCCCCCCCCC1111111111111111111111111W
W111111111111111111111111PP11RRRW0WCCCCCCCCCCCCCCCW1WWWWWW111111111111111111W
W111111111111111111111111PP11RRRW0WCCCCCCCCCCCCCCCW1W0000WWWWWWWWWWW1WWWWWWWW
W111111111111111111WWWWWWWWWWWWWWWWCCCCCCCCCCCCCCCW1W0000WCCCCCCCCCCCCCCCCCCW
W111111111111111111W00000W11111111CCCCCCCCCCCCCCCCW1W0000WCCCCCCCCCCCCCCCCCCW
W111111111111111111WWWWWWW11111111CCCCCCCCCCCCCCCCW1W0000WCCCCCCCCCCCCCCCCCCW
W111111111111111111111W11111111111WWWWCCWWWWWWWWWWW1WW000WCCCCCCCCCCCCCCCCCCW
W1111111111111111111111111111111111111111111111111111W000WCCCCCCCCCCCCCCCCCCW
W111111111111111111111W11111111111WWWW1WWWWWW11111111W000WCCCCCCCCCCCCCCCCCCW
W111111111111111111WWWWWWW11111111W00W1W0000W11111111W000WCCCCCCCCCCCCCCCCCCW
W111111111111111111W00000W11111111W00W1W0000W11111111W000WCCCCCCCCCCCCCCCCCCW
W111111111111111111W00000W111WWWWWW00W1W0000WWWW111WWW000WWWWWWWWWWWWWWWWWWWW
WWWWWWWWW1WWWWWWWWWW00WWWW111W0000000W1W0000000W111W
0000WWWWW1WWCCCCCCCCCCWWW111WW0000WWWW1WWWW000W111W
0000WWWWW1WWCCCCCCCCCCWW111WWW0000W1111111W00W111W
0000WWWW111WCCCCCCCCCCW111WWWW0000W1111111W0W111W
0000WWW111WWCCCCCCCCCCWW111WWW0000W1111111WW111W
0000WW111WWWCCCCCCCCCCWWW111WW0000WWWWWWWWW111W
0000W111WWWWCCCCCCCCCCWWWW111W00000000000W111W
0000WW111WWWCCCCCCCCCCWWW111WW0000000000W111W
0000WWW111WWCCCCCCCCCCWW111WWW000000000W111W
0000WWWW111WCCCCCCCCCCW111WWWW00000000W111W
WWWWWWWWCCCWWWWCWWWWWWWCCCWWWW0000000W111W
WCCCCCCCCCCCCCWCCCCCCCCCCCCCCW000000W111W
WCCCCCCCCCCCCCWCCCCCCCCCCCCCCW00000W111W
WCCCCCCCCCCCCCWCCCCCCCCCCCCCCW0000W111W
WCCCCCCCCCCCCCWCCCCCCCCCCCCCCW000W111W
WCCCCCCCCCCCCCCCCCCCCCCCCCCCCW00W111W
WCCCCCCCCCCCCCWCCCCCCCCCCCCCCW0W111W
WCCCCCCCCCCCCCWCCCCCCCCCCCCCCWW111W
WCCCCCCCCCCCCCWCCCCCCCCCCCCCC1111W
WCCCCCCCCCCCCCWCCCCCCCCCCCCCC111W
WWWWWWWWWWWWWWWWWWWWWWWWWWWWWWWW