>11111111WWWWWWWWWWWWWWWW111111111111111
111111111WCCCCCCCW111111W111111111111111
11O111111WCCCCCCCW111111W111111111111111
111111111CCCCCCCCW111111W111111111111111
111111111WCCCCCCCW1PPPP1W111111111111111
111111111WCCCCCCCW111111W111111111111111
111111111WWWWWWWWW111111W111111111111111
11111111111111111W111111W111111111111111
11111111111111111W111111W111111111111111
11111111111111111WWW11WWW111111111111111
WWWWWCWWWWW11111111111111111111111111111
WCCCCCCCCCW11111111111111111111111111111
WCCCCCCCCCW11111111111111111111111111111
WCCCCCCCCCW11111111111111111111111111111
WCCCCCCCCCW11111111111111111111111111111
WCCCCCCCCCW11111111111111111111111111111
WCCCCCCCCCW11111111111111111111111111111
WWWWWWWWWWW11111111111111111111111111111
1111111111111111111111111111111111111111
1111111111111111111111111111111111111111
1111111111111111111111111111111111111111
1111111111111111111111111111111111111111
1111111111111111111111111111111111111111
1111111111111111111111111111111111111111
1111111111111111111111111111111111111111
1111111111111111111111111111111111111111
1111111111111111111111111111111111111111
1111111111111111111111111111111111111111
1111111111111111111111111111111111111111
1111111111111111111111111111111111111111
1111111111111111111111111111111111111111
1111111111111111111111111111111111111111
1111111111111111111111111111111111111111
1111111111111111111111111111111111111111
1111111111111111111111111111111111111111
1111111111111111111111111111111111111111
1111111111111111111111111111111111111111
1111111111111111111111111111111111111111
1111111111111111111111111111111111111111
1111111111111111111111111111111111111111
