Snowy               
WWWWWWWWWWWWWWWWWWWW
WCCCCCCCCCCCCCCCCCCW
WCCCCCCCCCCCCCCCCCCW
WCCCCCCCCCCCCCCCCCCW
WCCCCCCCCCCCCCCCCCCW
WCCCCCCCCCCCCCCCCCCW
WCCCCCCCCCCCCCCCCCCW
WCCCCCCCCCCCCCCCCCCW
WCCCCCCCCCCCCCCCCCCW
WCCCCCCCCCCCCCCCCCCW
WCCCCCCCCCCCCCCCCCCW
WCCCCCCCCCCCCCCCCCCW
WCCCCCCCCCCCCCCCCCCW
WCCCCCCCCCCCCCCCCCCW
WWWWWWWWWCCWWWWWWWWW
W1111111111>111LLLLW
W11111111111111LLLLW
WPP11111111111122RRW
W*P11111O11111122RRW
WWWWWWWWWWWWWWWWWWWW
