Volcano             
WWWWWWWWWWWWWWWWWWWW
WRRRRRRRRRRRRRRRRRRW
WRRRRRRRRRRRRRRRRRRW
WRRRRRRRRRRRRRRRRRRW
WRRRRRRRRRRRRRRRRRRW
WRRRRRRRRRRRRRRRRRRW
WRRRRRRRRRRRRRRRRRRW
WRRRRRRRRRRRRRRRRRRW
WRRRRRRRRRRRRRRRRRRW
WRRRRRRRRRRRRRRRRRRW
WRRRRRRRRRRRRRRRRRRW
WRRRRRRRRRRRRRRRRRRW
WRRRRRRRRRRRRRRRRRRW
WWWWRRRRRRRRRRRRRRRW
W22RRRRRWLLLLLLLLLLW
W22WRRRRWLLLLLLLLLLW
W11WRRRRWLLLLLLLLLLW
W11WCCPRWLLLLLLLLLLW
WO>W*CPRWLLLLLLLLLLW
WWWWWWWWWWWWWWWWWWWW
