Grassy    
WWWWWWWWWW
W11111111W
W11LLL111W
W1>LLL111W
WO1LLL111W
W11111111W
W11111111W
W11111111W
W11111111W
WWWWWWWWWW
