Grassy,none,1
IIIIIIIIIIIIIIIIIIIIIIIIIIIIIIIIIIIIIIIIIIIIIIIIIIII
I22PPPPPPPPPPPPPPPPPPPPPPP2222111111111111111WWWWWWI
I122222222222PPPPPPPPPPP22221111111111111111WWWWWWWI
IRRRRRRR222222PPPPPPPP222221111111111111111WWWWWWWWI
IRRRRRRRR122222PPPPPPP222211111111111111111WWWWWWWWI
IRRRRRRRRRRRRRRPPPPPPRRRRRR1111111111111111WWWWWWWWI
I111111RRRRRRRRRRRRRRRRRRRRR1111111111111111WWWWWWWI
I1111111RRRRRRRRPPRRRRRRRRRRR111111111111111WWWWWWWI
I11111111112222PPPPP22222RRRRR11111111111111WWWWWWWI
I11111111112222PPPPPP22221RRRR111111111111111WWWWWWI
I11111111122222PPPPPPP22221RRR1111111111111111WWW22I
I1111111122222PPPPPPPP22221RRR1111111111111112WW222I
I1111111222PPPPPPPPPPPP2222RRR111111111111112222222I
I11111222PPPPPPPPPPPPPP2222RRR11111111111112221WWWWI
I1111222PPPPPPPPPPPPPPPP222RRRR1111111111122211WWWWI
I11222PPPPPPPPPPPPPPPPPP222RRRRRRRRRRRRRRRRRRRRRRRRI
I1122PPPPPPPPPPPPPPPPPPP2222RRRRRRRRRRRRRRRRRRRRRRRI
I1122PPPPPPPPPPPPPPPPPPPP2222RRRRRRRRRRRRRRRRRRRRRRI
I1122PPPPPPPPPPPPPPPPPPPPP222211111111111111111111WI
I1122PPPPPPPPPPPPPPPPPPPPP2222111111111111111111111I
IIIIIIIIIIIIIIIIIIIIIIIIIIIIIIIIIIIIIIIIIIIIIIIIIIII
