Grassy,none,2
IIIIIIIIIIIIIIIIIIIIIIIIIIIIIIIIIIIIIIIIIIIIIIIIIIII
I22PPPPPPPPPPPPPPPPPPPPPPP2222111111111111111111111I
I122222222222PPPPPPPPPPP222211111111111111111111111I
IRRRRRRR222222PPPPPPPP22222111111111111111111111111I
IRRRRRRRR122222PPPPPPP22221111111111111111111111111I
IRRRRRRRRRRRRRRPPPPPPRRRRRR111111111111111111111111I
I111111RRRRRRRRRRRRRRRRRRRRR11111111111111111111111I
I1111111RRRRRRRRPPRRRRRRRRRRR1111111111111111111111I
I11111111112222PPPPP22222RRRRR1111111111111111111WWI
I11111111112222PPPPPP22221RRRR111111111111111111WWWI
I11111111122222PPPPPPP22221RRR11111111111111111WW11I
I1111111122222PPPPPPPP22221RRR1111111111111111WW111I
I1111111222PPPPPPPPPPPP2222RRR111111111111111111111I
I11111222PPPPPPPPPPPPPP2222RRR11111111111111111WWWWI
I1111222PPPPPPPPPPPPPPPP222RRRR1111111111111111WWWWI
I11222PPPPPPPPPPPPPPPPPP222RRRRRRRRRRRRRRRRRRRRRRRRI
I1122PPPPPPPPPPPPPPPPPPP2222RRRRRRRRRRRRRRRRRRRRRRRI
I1122PPPPPPPPPPPPPPPPPPPP2222RRRRRRRRRRRRRRRRRRRRRRI
I1122PPPPPPPPPPPPPPPPPPPPP222211111111111111111111WI
I1122PPPPPPPPPPPPPPPPPPPPP2222111111111111111111111I
IIIIIIIIIIIIIIIIIIIIIIIIIIIIIIIIIIIIIIIIIIIIIIIIIIII
