Desert
WWWWWWWWWWWWWWWWWWWWWWWWWWWWWWWWWWWWWWWWWWWWWWWWWW
W11111111111WRRRRRRRRRRRW111111111111111111111111W
W11111111111WRRRRRRRRRRRW111111111111111111111111W
W11111111111WRRRRRRRRRRRW111111111111111111111111W
W11111O11111WRRRRRRRRRRRW111111111111111111111111W
W11111111111WRRRRRRRRRRRW111111111111111111111111W
W11111111111WRRRRRRRRRRRW111111111111111111111111W
W11111111111WRRRRRRRRRRRW111111111111111111111111W
W11111111111WRRRRRRRRRRRW111111111111111111111111W
W11111111111WRRRRRRRRRRRW111111111111111111111111W
W11111111111WWWWWRRRWWWWWWWWWWWWWWWWW111111111111W
W11111111111WRRRRRRRRRRRWRRRRRWCCC**W111111111111W
W1111111111>WRRRRRRRRRRRWRRRRRWCCCCCWWWWWWWWW1111W
W11111111111WRRRRRRRRRRRWRRRRRWCCCCCWCCCCCC*W1111W
W11111111111WRRRWRRRWRRRWRRRRRWCCCCCWCCCCCCCW1111W
W11111111111RRRRRCCCRRRRRRRRRRWCCCCCWCCCCCCCW1111W
W11111111111RRRRRCCCRRRRRRRRRRCCCCCCCCCCCC**W1111W
W11111111111RRRRRCCCRRRRRRRRRRWCCCCCWCCCCCCCW1111W
W11111111111WRRRWRRRWRRRWRRRRRWCCCCCWCCCCCCCW1111W
W11111111111WRRRRRRRRRRRWRRRRRWCCCCCWCCCCCC*W1111W
W11111111111WRRRRRRRRRRRWRRRRRWCCCCCWWWWWWWWW1111W
W11111111111WRRRRRRRRRRRWRRRRRWCCC**W111111111111W
WWWWWWWWWWWWWWWWWRRRWWWWWWWWWWWWWWWWW111111111111W
W1111111111111WRRRRRRRW11111111111111111111111111W
W1111111111111WRRRRRRRW11111111111111111111111111W
W1111111111111WRRRRRRRW11111111111111111111111111W
W1111111111111WRRRRRRRW11111111111111111111111111W
W11111111111111RRRRRRRW11111111111111111111111111W
W1111111111111WRRRRRRRW11111111111111111111111111W
W1111111111111WRRRRRRRW11111111111111111111111111W
W1111111111111WWWWWWWWW11111111111111111111111111W
W111111111111111111111111111111111111111111111111W
W111111111111111111111111111111111111111111111111W
W111111111111111111111111111111111111111111111111W
W111111111111111111111111111111111111111111111111W
W111111111111111111111111111111111111111111111111W
W111111111111111111111111111111111111111111111111W
W111111111111111111111111111111111111111111111111W
W111111111111111111111111111111111111111111111111W
W111111111111111111111111111111111111111111111111W
W111111111111111111111111111111111111111111111111W
W111111111111111111111111111111111111111111111111W
W111111111111111111111111111111111111111111111111W
W111111111111111111111111111111111111111111111111W
W111111111111111111111111111111111111111111111111W
W111111111111111111111111111111111111111111111111W
W111111111111111111111111111111111111111111111111W
W111111111111111111111111111111111111111111111111W
W111111111111111111111111111111111111111111111111W
WWWWWWWWWWWWWWWWWWWWWWWWWWWWWWWWWWWWWWWWWWWWWWWWWW
