Grassy,none,1
IIIIIIIIIIIIIIIIIIIIIIIIIII
I0000000WWWWWWWWWWW0000000I
I00000WWRRRRRRRRRRRWW00000I
I0000WRRRRRRRRRRRRRRRW0000I
I000WWRRRRRRRRRRRRRRRWW000I
I00WWRRRRRRRRRRRRRRRRRWW00I
I0WRRRRRRRRRRRRRRRRRRRRRW0I
I0WRRRRRRRRRRRRRRRRRRRRRW0I
IWRRRRRRRRRRRRRRRRRRRRRRRWI
IWRRRRRRRRRRRRRRRRRRRRRRRWI
IWRRRRRRRRRRRRRRRRRRRRRRRWI
IWRRRRRRRRRRRRRRRRRRRRRRRWI
IWRRRRRRRRRRRRRRRRRRRRRRRWI
IWRRRRRRRRRRRRRRRRRRRRRRRWI
IWRRRRRRRRRRRRRRRRRRRRRRRWI
IWRRRRRRRRRRRRRRRRRRRRRRRWI
IWRRRRRRRRRRRRRRRRRRRRRRRWI
IWRRRRRRRRRRRRRRRRRRRRRRRWI
IWRRRRRRRRRRRRRRRRRRRRRRRWI
I0WRRRRRRRRRRRRRRRRRRRRRW0I
I0WRRRRRRRRRRRRRRRRRRRRRW0I
I00WWRRRRRRRRRRRRRRRRRWW00I
I000WWRRRRRRRRRRRRRRRWW000I
I0000WRRRRRRRRRRRRRRRW0000I
I00000WWRRRRRRRRRRRWW00000I
I0000000WWWWWWWWWWW0000000I
IIIIIIIIIIIIIIIIIIIIIIIIIII
