Grassy                          
IIIIIIIIIIIIIIIIIIIIIIIIIIIIIIII
I111111111111111111111111111111I
I111111111111111111111111111111I
I111111111111111111111L11111111I
I1LL1111L1111111111111LL111L111I
I1LLLLLLLLLRRRRRRRRRRLLLLLLLLLLI
ILLLLLLLLLLRRRRRRRRRRLLLLLLLLLLI
ILLLLLLLLLLRRRRRRRRRRLLLLLLLLLLI
ILLLLLLLLLLRRRRRRRRRRLLLLLLLLLLI
ILLLLLLLLLLRRRRRRRRRRLLLLLLLLLLI
ILLLLLLLLLLRRRRRRRRRRLLLLLLLLLLI
ILLLLLLLLLLRRRRRRRRRRLLLLLLLLLLI
ILLLLLLLLLLRRRRRRRRRRLLLLLLLLLLI
ILLLLLLLLLLRRRRRRRRRRLLLLLLLLLLI
ILLLLLLLLLLRRRRRRRRRRLLLLLLLLLLI
ILLLLLLLLLLRRRRRRRRRRLLLLLLLLLLI
ILLLLLLLLLLRRRRRRRRRRLLLLLLLLLLI
ILLLLLLLLLLRRRRRRRRRRLLLLLLLLLLI
ILLLLLLLLLLRRRRRRRRRRLLLLLLLLLLI
ILLLLLLLLLLRRRRRRRRRRLLLLLLLLLLI
ILLLLLLLLLLRRRRRRRRRRLLLLLLLLLLI
ILLLLLLLLLLRRRRRRRRRRLLLLLLLLLLI
ILLLLLLLLLLRRRRRRRRRRLLLLLLLLLLI
ILLLLLLLLLLRRRRRRRRRRLLLLLLLLLLI
ILLLLLLLLLLRRRRRRRRRRLLLLLLLLLLI
ILLLLLLLLLLRRRRRRRRRRLLLLLLLLLLI
ILLLLLLLLLLRRRRRRRRRRLLLLLLLLLLI
ILLLLLLLLLLRRRRRRRRRRLLLLLLLLLLI
ILLLLLLLLLLRRRRRRRRRRLLLLLLLLLLI
ILLLLLLLLLLRRRRRRRRRRLLLLLLLLLLI
ILLLLLLLLLLRRRRRRRRRRLLLLLLLLLLI
ILLLLLLLLLLRRRRRRRRRRLLLLLLLLLLI
ILLLLLLLLLLRRRRRRRRRRLLLLLLLLLLI
ILLLLLLLLLLRRRRRRRRRRLLLLLLLLLLI
ILLLLLLLLLLRRRRRRRRRRLLLLLLLLLLI
ILLLLLLLLLLRRRRRRRRRRLLLLLLLLLLI
ILLLLLLLLLLRRRRRRRRRRLLLLLLLLLLI
ILLLLLLLLLLRRRRRRRRRRLLLLLLLLLLI
ILLLLLLLLLLRRRRRRRRRRLLLLLLLLLLI
ILLLLLLLLLLRRRRRRRRRRLLLLLLLLLLI
ILLLLLLLLLLRRRRRRRRRRLLLLLLLLLLI
ILLLLLLLLLLRRRRRRRRRRLLLLLLLLLLI
ILLLLLLLLLLRRRRRRRRRRLLLLLLLLLLI
ILLLLLLLLLLRRRRRRRRRRLLLLLLLLLLI
ILLLLLLLLLLRRRRRRRRRRLLLLLLLLLLI
ILLLLLLLLLLRRRRRRRRRRLLLLLLLLLLI
ILLLLLLLLLLRRRRRRRRRRLLLLLLLLLLI
ILLLLLLLLLLRRRRRRRRRRLLLLLLLLLLI
ILLLLLLLLLLRRRRRRRRRRLLLLLLLLLLI
ILLLLLLLLLLRRRRRRRRRRLLLLLLLLLLI
ILLLLLLLLLLRRRRRRRRRRLLLLLLLLLLI
ILLLLLLLLLLRRRRRRRRRRLLLLLLLLLLI
ILLLLLLLLLLRRRRRRRRRRLLLLLLLLLLI
ILLLLLLLLLLRRRRRRRRRRLLLLLLLLLLI
ILLLLLLLLLLRRRRRRRRRRLLLLLLLLLLI
ILLLLLLLLLLRRRRRRRRRRLLLLLLLLLLI
ILLLLLLLLLLRRRRRRRRRRLLLLLLLLLLI
ILLLLLLLLLLRRRRRRRRRRLLLLLLLLLLI
ILLLLLLLLLLRRRRRRRRRRLLLLLLLLLLI
ILLLLLLLLLLRRRRRRRRRRLLLLLLLLLLI
ILLLLLLLLLLRRRRRRRRRRLLLLLLLLLLI
ILLLLLLLLLLRRRRRRRRRRLLLLLLLLLLI
ILLLLLLLLLLRRRRRRRRRRLLLLLLLLLLI
ILLLLLLLLLLRRRRRRRRRRLLLLLLLLLLI
ILLLLLLLLLLRRRRRRRRRRLLLLLLLLLLI
ILLLLLLLLLLRRRRRRRRRRLLLLLLLLLLI
ILLLLLLLLLLRRRRRRRRRRLLLLLLLLLLI
ILLLLLLLLLLRRRRRRRRRRLLLLLLLLLLI
ILLLLLLLLLLRRRRRRRRRRLLLLLLLLLLI
ILLLLLLLLLLRRRRRRRRRRLLLLLLLLLLI
ILLLLLLLLLLRRRRRRRRRRLLLLLLLLLLI
ILLLLLLLLLLRRRRRRRRRRLLLLLLLLLLI
ILLLLLLLLLLRRRRRRRRRRLLLLLLLLLLI
ILLLLLLLLLLRRRRRRRRRRLLLLLLLLLLI
ILLLLLLLLLLRRRRRRRRRRLLLLLLLLLLI
ILLLLLLLLLLRRRRRRRRRRLLLLLLLLLLI
ILLLLLLLLLLRRRRRRRRRRLLLLLLLLLLI
ILLLLLLLLLLRRRRRRRRRRLLLLLLLLLLI
ILLLLLLLLLLRRRRRRRRRRLLLLLLLLLLI
ILLLLLLLLLLRRRRRRRRRRLLLLLLLLLLI
ILLLLLLLLLLRRRRRRRRRRLLLLLLLLLLI
ILLLLLLLLLLRRRRRRRRRRLLLLLLLLLLI
ILLLLLLLLLLRRRRRRRRRRLLLLLLLLLLI
ILLLLLLLLLLRRRRRRRRRRLLLLLLLLLLI
ILLLLLLLLLLRRRRRRRRRRLLLLLLLLLLI
ILLLLLLLLLLRRRRRRRRRRLLLLLLLLLLI
ILLLLLLLLLLRRRRRRRRRRLLLLLLLLLLI
ILLLLLLLLLLRRRRRRRRRRLLLLLLLLLLI
ILLLLLLLLLLRRRRRRRRRRLLLLLLLLLLI
ILLLLLLLLLLRRRRRRRRRRLLLLLLLLLLI
ILLLLLLLLLLRRRRRRRRRRLLLLLLLLLLI
ILLLLLLLLLLRRRRRRRRRRLLLLLLLLLLI
ILLLLLLLLLLRRRRRRRRRRLLLLLLLLLLI
ILLLLLLLLLLRRRRRRRRRRLLLLLLLLLLI
ILLLLLLLLLLRRRRRRRRRRLLLLLLLLLLI
ILLLLLLLLLLRRRRRRRRRRLLLLLLLLLLI
ILLLLLLLLLLRRRRRRRRRRLLLLLLLLLLI
ILLLLLLLLLLRRRRRRRRRRLLLLLLLLLLI
ILLLLLLLLLLRRRRRRRRRRLLLLLLLLLLI
ILLLLLLLLLLRRRRRRRRRRLLLLLLLLLLI
ILLLLLLLLLLRRRRRRRRRRLLLLLLLLLLI
ILLLLLLLLLLRRRRRRRRRRLLLLLLLLLLI
ILLLLLLLLLLRRRRRRRRRRLLLLLLLLLLI
ILLLLLLLLLLRRRRRRRRRRLLLLLLLLLLI
ILLLLLLLLLLRRRRRRRRRRLLLLLLLLLLI
IIIIIIIIIIIIIIIIIIIIIIIIIIIIIIII
