Grassy                          
IIIIIIIIIIIIIIIIIIIIIIIIIIIIIIII
I111111111111111111111111111111I
I111111111111111111111111111111I
I111111111111111111111L11111111I
I1LL1111L1111111111111LL111L111I
I1LLLLLLLLLRRRRRRRRRRLLLLLLLLLLI
ILLLLLLLLLLRRRRRRRRRRLLLLLLLLLLI
ILLLLLLLLLLRRRRRRRRRRLLLLLLLLLLI
ILLLLLLLLLLRRRRRRRRRRLLLLLLLLLLI
ILLLLLLLLLLRRRRRRRRRRLLLLLLLLLLI
ILLLLLLLLLLRRRRRRRRRRLLLLLLLLLLI
ILLLLLLLLLLRRRRRRRRRRLLLLLLLLLLI
ILLLLLLLLLLRRRRRRRRRRLLLLLLLLLLI
ILLLLLLLLLLRRRRRRRRRRLLLL111LLLI
ILLLLLLLLLLRRRRRRRRRRLL11111LLLI
ILLLLLLLLLLRRRRRRRRRRLL111111LLI
ILLLLLLLLLLRRRRRRRRRRLLL11111LLI
ILLLLLLLLLLRRRRRRRRRRLLLLLLLLLLI
ILLLLLLLLLLRRRRRRRRRRLLLLLLLLLLI
ILLLLLLLLLLRRRRRRRRRRLLLLLLLLLLI
ILLLLLLLLLLRRRRRRRRRRLLLLLLLLLLI
ILLLLLLLLLLRRRRRRRRRRLLLLLLLLLLI
ILLLLLLLLLLRRRRRRRRRRLLLLLLLLLLI
ILLLLLLLLLLRRRRRRRRRRLLLLLLLLLLI
ILLLLLLLLLLRRRRRRRRRRLLLLLLLLLLI
ILLLLLLLLLLRRRRRRRRRRLLLLLLLLLLI
ILLLLLLLLLLRRRRRRRRRRLLLLLLLLLLI
ILLLLLLLLLLRRRRRRRRRRLLLLLLLLLLI
ILLLLLLLLLLRRRRRRRRRRLLLLLLLLLLI
ILLLLLLLLLLRRRRRRRRRRLLLLLLLLLLI
ILLLLLLLLLLRRRRRRRRRRLLLLLLLLLLI
ILLLLLLLLLLRRRRRRRRRRLLLLLLLLLLI
ILLLLLLLLLLRRRRRRRRRRLLLLLLLLLLI
ILLLLLLLLLLRRRRRRRRRRLLLLLLLLLLI
ILLLLLLLLLLRRRRRRRRRRLLLLLLLLLLI
ILLLLLLLLLLRRRRRRRRRRLLLLLLLLLLI
ILLLLLLLLLLRRRRRRRRRRLLLLLLLLLLI
ILLLLLLLLLLRRRRRRRRRRLLLLLLLLLLI
ILLLLLLLLLLRRRRRRRRRRLLLLLLLLLLI
ILLLLLLLLLLRRRRRRRRRRLLLLLLLLLLI
ILLLL112LLLRRRRRRRRRRLLLLLLLLLLI
ILLLL11LLLLRRRRRRRRRRLLLLLLLLLLI
ILLLL11LLLLRRRRRRRRRRLLLLLLLLLLI
ILLLLLLLLLLRRRRRRRRRRLLLLLLLLLLI
ILLLLLLLLLLRRRRRRRRRRLLLLLLLLLLI
ILLLLLLLLLLRRRRRRRRRRLLLLLLLLLLI
ILLLLRLLLLLRRRRRRRRRRLLLLLLLLLLI
ILLLLRLLLLLRRRRRRRRRRLLLLLLLLLLI
ILLLRRLLLLLRRRRRRRRRRLLLLLLLLLLI
ILLLRR2LLLLRRRRRRRRRRLLLLLLLLLLI
ILLLL22LLLLRRRRRRRRRRLLLLLLLLLLI
ILLLLLLLLLLRRRRRRRRRRLLLLLLLLLLI
ILLLLLLLLLLRRRRRRRRRRLLLLLLLLLLI
ILLLLL2LLLLRRRRRRRRRRLLLLLLLLLLI
ILLLLL11LLLRRRRRRRRRRLLLLLLLLLLI
ILLLLL111LLRRRRRRRRRRLLLLLLLLLLI
ILLLLL111LLRRRRRRRRRRLLLLLLLLLLI
ILLLLLLLLLLRRRRRRRRRRLLLLLLLLLLI
ILLLLLLLLLLRRRRRRRRRRLLLLLLLLLLI
ILLLLLLLLLLRRRRRRRRRRLLLLLLLLLLI
ILLLLLLLLLLRRRRRRRRRRLLLLLLLLLLI
ILLLLLLLLLLRRRRRRRRRRLLLLLLLLLLI
ILLLLLLLLLLRRRRRRRRRRLLLLLLLLLLI
ILLLLLLLLLLRRRRRRRRRRLLLLLLLLLLI
ILLLLLLLLLLRRRRRRRRRRLLLLLLLLLLI
ILLLLLLLLLLRRRRRRRRRRLLLLLLLLLLI
ILLLLLLLLLLRRRRRRRRRRLLLLLLLLLLI
ILLLLLLLLLLRRRRRRRRRRLLLLLLLLLLI
ILLLLLLLLLLRRRRRRRRRRLLLLLLLLL1I
ILLLLLLLLLLRRRRRRRRRRLLLLLLL111I
ILLLLLLLLLLRRRRRRRRRRLLLLLLL111I
ILLLLLLLLLLRRRRRRRRRRLLLLLLL111I
ILLLLLLLLLLRRRRRRRRRRLLLLLLL111I
ILLLLLLLLLLRRRRRRRRRRLLL11LLLLLI
ILLLLLLLLLLRRRRRRRRRRLL211LLLLLI
ILLLLLLLLLLRRRRRRRRRRLL222LLLLLI
ILLLLLLLLLLRRRRRRRRRRLLLLLLLLLLI
ILLLLLLLLLLRRRRRRRRRRLLLLLLLLLLI
ILLLLLLLLLLRRRRRRRRRRLLLLLLLLLLI
ILLLLLLLLLLRRRRRRRRRRLLLLLLLLLLI
ILLLLLLLLLLRRRRRRRRRRLLLLLLLLLLI
ILLLLLLLLLLRRRRRRRRRRLLLLLLLLLLI
ILLLLLLLLLLRRRRRRRRRRLLLLLLLLLLI
ILLLLLLLLLLRRRRRRRRRRLLLLLLLLLLI
ILLLLLLLLLLRRRRRRRRRRLLLLLLLLLLI
ILLLLLLLLLLRRRRRRRRRRLLLLLLLLLLI
ILLLLLLLLLLRRRRRRRRRRLLLLLLLLLLI
ILLLLLLLLLLRRRRRRRRRRLLLLLLLLLLI
ILLLLLLLLLLRRRRRRRRRRLLLLLLLLLLI
ILLLLLLLLLLRRRRRRRRRRLLLLLLLLLLI
ILLLLLLLLLLRRRRRRRRRRLLLLLLLLLLI
IL1111LLLLLRRRRRRRRRRLLLLLLLLLLI
IL111111LLLRRRRRRRRRRLLLLLLLLLLI
IL1111111LLRRRRRRRRRRLLLLLLLLLLI
IL1111111LLRRRRRRRRRRLLLLLLLLLLI
IL111111LLLRRRRRRRRRRLLLLLLLLLLI
ILL1111LLLLRRRRRRRRRRLLLLLLLLLLI
ILLLLLLLLLLRRRRRRRRRRLLLLLLLLLLI
ILLLLLLLLLLRRRRRRRRRRLLLLLLLLLLI
ILLLLLLLLLLRRRRRRRRRRLLLLLLLLLLI
ILLLLLLLLLLRRRRRRRRRRLLLLLLLLLLI
ILLLLLLLLLLRRRRRRRRRRLLLLLLLLLLI
ILLLLLLLLLLRRRRRRRRRRLLLLLLLLLLI
ILLLLLLLLLLRRRRRRRRRRLLLLLLLLLLI
ILLLLLLLLLLRRRRRRRRRRLLLLLLLLLLI
IIIIIIIIIIIIIIIIIIIIIIIIIIIIIIII
