Grassy                          
IIIIIIIIIIIIIIIIIIIIIIIIIIIIIIII
I111111111111111111111111111111I
I111111111111111111111111111111I
I111111111111111111111111111111I
I1PP111111111111111111PP1111111I
I1PPPPPPPPPRRRRRRRRRRPPPPPPPPPPI
IPPPPPPPPPPRRRRRRRRRRPPPPPPPPPPI
IPPPPPPPPPPRRRRRRRRRRPPPPPPPPPPI
IPPPPPPPPPPRRRRRRRRRRPPPPPPPPPPI
IPPPPPPPPPPRRRRRRRRRRPPPPPPPPPPI
IPPPPPPPPPPRRRRRRRRRRPPPPPPPPPPI
IPPPPPPPPPPRRRRRRRRRRPPPPPPPPPPI
IPPPPPPPPPPRRRRRRRRRRPPPPPPPPPPI
IPPPPPPPPPPRRRRRRRRRRPPPPPPPPPPI
IPPPPPPPPPPRRRRRRRRRRPPPPPPPPPPI
IPPPPPPPPPPRRRRRRRRRRPPPPPPPPPPI
IPPPPPPPPPPRRRRRRRRRRPPPPPPPPPPI
IPPPPPPPPPPRRRRRRRRRRPPPPPPPPPPI
IPPPPPPPPPPRRRRRRRRRRPPPPPPPPPPI
IPPPPPPPPPPRRRRRRRRRRPPPPPPPPPPI
IPPPPPPPPPPRRRRRRRRRRPPPPPPPPPPI
IPPPPPPPPPPRRRRRRRRRRPPPPPPPPPPI
IPPPPPPPPPPRRRRRRRRRRPPPPPPPPPPI
IPPPPPPPPPPRRRRRRRRRRPPPPPPPPPPI
IPPPPPPPPPPRRRRRRRRRRPPPPPPPPPPI
IPPPPPPPPPPRRRRRRRRRRPPPPPPPPPPI
IPPPPPPPPPPRRRRRRRRRRPPPPPPPPPPI
IPPPPPPPPPPRRRRRRRRRRPPPPPPPPPPI
IPPPPPPPPPPRRRRRRRRRRPPPPPPPPPPI
IPPPPPPPPPPRRRRRRRRRRPPPPPPPPPPI
IPPPPPPPPPPRRRRRRRRRRPPPPPPPPPPI
IPPPPPPPPPPRRRRRRRRRRPPPPPPPPPPI
IPPPPPPPPPPRRRRRRRRRRPPPPPPPPPPI
IPPPPPPPPPPRRRRRRRRRRPPPPPPPPPPI
IPPPPPPPPPPRRRRRRRRRRPPPPPPPPPPI
IPPPPPPPPPPRRRRRRRRRRPPPPPPPPPPI
IPPPPPPPPPPRRRRRRRRRRPPPPPPPPPPI
IPPPPPPPPPPRRRRRRRRRRPPPPPPPPPPI
IPPPPPPPPPPRRRRRRRRRRPPPPPPPPPPI
IPPPPPPPPPPRRRRRRRRRRPPPPPPPPPPI
IPPPPPPPPPPRRRRRRRRRRPPPPPPPPPPI
IPPPPPPPPPPRRRRRRRRRRPPPPPPPPPPI
IPPPPPPPPPPRRRRRRRRRRPPPPPPPPPPI
IPPPPPPPPPPRRRRRRRRRRPPPPPPPPPPI
IPPPPPPPPPPRRRRRRRRRRPPPPPPPPPPI
IPPPPPPPPPPRRRRRRRRRRPPPPPPPPPPI
IPPPPPPPPPPRRRRRRRRRRPPPPPPPPPPI
IPPPPPPPPPPRRRRRRRRRRPPPPPPPPPPI
IPPPPPPPPPPRRRRRRRRRRPPPPPPPPPPI
IPPPPPPPPPPRRRRRRRRRRPPPPPPPPPPI
IPPPPPPPPPPRRRRRRRRRRPPPPPPPPPPI
IPPPPPPPPPPRRRRRRRRRRPPPPPPPPPPI
IPPPPPPPPPPRRRRRRRRRRPPPPPPPPPPI
IPPPPPPPPPPRRRRRRRRRRPPPPPPPPPPI
IPPPPPPPPPPRRRRRRRRRRPPPPPPPPPPI
IPPPPPPPPPPRRRRRRRRRRPPPPPPPPPPI
IPPPPPPPPPPRRRRRRRRRRPPPPPPPPPPI
IPPPPPPPPPPRRRRRRRRRRPPPPPPPPPPI
IPPPPPPPPPPRRRRRRRRRRPPPPPPPPPPI
IPPPPPPPPPPRRRRRRRRRRPPPPPPPPPPI
IPPPPPPPPPPRRRRRRRRRRPPPPPPPPPPI
IPPPPPPPPPPRRRRRRRRRRPPPPPPPPPPI
IPPPPPPPPPPRRRRRRRRRRPPPPPPPPPPI
IPPPPPPPPPPRRRRRRRRRRPPPPPPPPPPI
IPPPPPPPPPPRRRRRRRRRRPPPPPPPPPPI
IPPPPPPPPPPRRRRRRRRRRPPPPPPPPPPI
IPPPPPPPPPPRRRRRRRRRRPPPPPPPPPPI
IPPPPPPPPPPRRRRRRRRRRPPPPPPPPPPI
IPPPPPPPPPPRRRRRRRRRRPPPPPPPPPPI
IPPPPPPPPPPRRRRRRRRRRPPPPPPPPPPI
IPPPPPPPPPPRRRRRRRRRRPPPPPPPPPPI
IPPPPPPPPPPRRRRRRRRRRPPPPPPPPPPI
IPPPPPPPPPPRRRRRRRRRRPPPPPPPPPPI
IPPPPPPPPPPRRRRRRRRRRPPPPPPPPPPI
IPPPPPPPPPPRRRRRRRRRRPPPPPPPPPPI
IPPPPPPPPPPRRRRRRRRRRPPPPPPPPPPI
IPPPPPPPPPPRRRRRRRRRRPPPPPPPPPPI
IPPPPPPPPPPRRRRRRRRRRPPPPPPPPPPI
IPPPPPPPPPPRRRRRRRRRRPPPPPPPPPPI
IPPPPPPPPPPRRRRRRRRRRPPPPPPPPPPI
IPPPPPPPPPPRRRRRRRRRRPPPPPPPPPPI
IPPPPPPPPPPRRRRRRRRRRPPPPPPPPPPI
IPPPPPPPPPPRRRRRRRRRRPPPPPPPPPPI
IPPPPPPPPPPRRRRRRRRRRPPPPPPPPPPI
IPPPPPPPPPPRRRRRRRRRRPPPPPPPPPPI
IPPPPPPPPPPRRRRRRRRRRPPPPPPPPPPI
IPPPPPPPPPPRRRRRRRRRRPPPPPPPPPPI
IPPPPPPPPPPRRRRRRRRRRPPPPPPPPPPI
IPPPPPPPPPPRRRRRRRRRRPPPPPPPPPPI
IPPPPPPPPPPRRRRRRRRRRPPPPPPPPPPI
IPPPPPPPPPPRRRRRRRRRRPPPPPPPPPPI
IPPPPPPPPPPRRRRRRRRRRPPPPPPPPPPI
IPPPPPPPPPPRRRRRRRRRRPPPPPPPPPPI
IPPPPPPPPPPRRRRRRRRRRPPPPPPPPPPI
IPPPPPPPPPPRRRRRRRRRRPPPPPPPPPPI
IPPPPPPPPPPRRRRRRRRRRPPPPPPPPPPI
IPPPPPPPPPPRRRRRRRRRRPPPPPPPPPPI
IPPPPPPPPPPRRRRRRRRRRPPPPPPPPPPI
IPPPPPPPPPPRRRRRRRRRRPPPPPPPPPPI
IPPPPPPPPPPRRRRRRRRRRPPPPPPPPPPI
IPPPPPPPPPPRRRRRRRRRRPPPPPPPPPPI
IPPPPPPPPPPRRRRRRRRRRPPPPPPPPPPI
IPPPPPPPPPPRRRRRRRRRRPPPPPPPPPPI
IPPPPPPPPPPRRRRRRRRRRPPPPPPPPPPI
IPPPPPPPPPPRRRRRRRRRRPPPPPPPPPPI
IIIIIIIIIIIIIIIIIIIIIIIIIIIIIIII
