Volcano,none,1,0
IIIIIIIIIIIIIIIIIIIIIIIIIIIIIIIIII
I0000000000WWWWWWWWWWWW0000000000I
I0000000000WRRRRRRRRRRW0000000000I
I0000000000WRRRRRRRRRRW0000000000I
I0000000000WRRRRRRRRRRW0000000000I
I0000000000WRRRRRRRRRRW0000000000I
I0000000000WRRRRRRRRRRW0000000000I
IWWWWWWWWWWWWWWRRRRWWWWWWWWWWWWWWI
IWRRRRRRRRRRRRRRRRRRRRRRRRRRRRRRWI
IWRRRRRRRRRRRRRRRRRRRRRRRRRRRRRRWI
IWRRRRRRRRRRRRRRRRRRRRRRRRRRRRRRWI
IWRRRRRRRRRRRRRRRRRRRRRRRRRRRRRRWI
IWRRRRRRRRRRRRRRRRRRRRRRRRRRRRRRWI
IWRRRRRRRRRRRRRRRRRRRRRRRRRRRRRRWI
IWRRRRRRRRRRRRRRRRRRRRRRRRRRRRRRWI
IWRRRRRRRRRRRRRRRRRRRRRRRRRRRRRRWI
IWRRRRRRRRRRRRRRRRRRRRRRRRRRRRRRWI
IWRRRRRRRRRRRRRRRRRRRRRRRRRRRRRRWI
IWRRRRRRRRRRRRRRRRRRRRRRRRRRRRRRWI
IWRRRRRRRRRRRRRRRRRRRRRRRRRRRRRRWI
IWRRRRRRRRRRRRRRRRRRRRRRRRRRRRRRWI
IWRRRRRRRRRRRRRCCCCRRRRRRRRRRRRRWI
IWRRRRRRRRRRRRRCCCCRRRRRRRRRRRRRWI
IWRRRRRRRRRRRRRCCCCRRRRRRRRRRRRRWI
IWRRRRRRRRRRRRRCCCCRRRRRRRRRRRRRWI
IWRRRRRRRRRRRRRRRRRRRRRRRRRRRRRRWI
IWRRRRRRRRRRRRRRRRRRRRRRRRRRRRRRWI
IWRRRRRRRRRRRRRRRRRRRRRRRRRRRRRRWI
IWRRRRRRRRRRRRRRRRRRRRRRRRRRRRRRWI
IWRRRRRRRRRRRRRRRRRRRRRRRRRRRRRRWI
IWRRRRRRRRRRRRRRRRRRRRRRRRRRRRRRWI
IWRRRRRRRRRRRRRRRRRRRRRRRRRRRRRRWI
IWRRRRRRRRRRRRRRRRRRRRRRRRRRRRRRWI
IWRRRRRRRRRRRRRRRRRRRRRRRRRRRRRRWI
IWRRRRRRRRRRRRRRRRRRRRRRRRRRRRRRWI
IWRRRRRRRRRRRRRRRRRRRRRRRRRRRRRRWI
IWRRRRRRRRRRRRRRRRRRRRRRRRRRRRRRWI
IWRRRRRRRRRRRRRRRRRRRRRRRRRRRRRRWI
IWWWWWWWWWWWWWRRRRRRWWWWWWWWWWWWWI
IWRRRRRRWRRRRRRRRRRRRRRRRWRRRRRRWI
IWRRRRRRWRRRRRRRRRRRRRRRRWRRRRRRWI
IWRRRRRRRRRRRRRRRRRRRRRRRRRRRRRRWI
IWRRRRRRRRRRRRRRRRRRRRRRRRRRRRRRWI
IWRRRRRRWRRRRRRRRRRRRRRRRWRRRRRRWI
IWRRRRRRWRRRRRRRRRRRRRRRRWRRRRRRWI
IWWWWWWWWWWWWWWWWWWWWWWWWWWWWWWWWI
IIIIIIIIIIIIIIIIIIIIIIIIIIIIIIIIII
