Grassy                     
IIIIIIIIIIIIIIIIIIIIIIIIIII
I1111111111111111111111111I
I1O11111111111111111111111I
I1111111111111111111111111I
I1111111111111111111111111I
I1111111111111111111111111I
I1111111111111111111111111I
I1111111111111111111111111I
I1111111111111111111111111I
I1111111111111111111111111I
I1111111111111111111111111I
I1111111111111111111111111I
I1111111111111111111111111I
I1111111111111111111111111I
I1111111111111111111111111I
I1111111111111111111111111I
I1111111111111111111111111I
I1111111111111111111111111I
I1111111111111111111111111I
I1111111111111111111111111I
I1111111111111111111111111I
I1111111111111111111111111I
I1111111111111111111111111I
I1111111111111111111111111I
I1111111111111111111111111I
I1111111111111111111111111I
IIIIIIIIIIIIIIIIIIIIIIIIIII
