W1111111111111111111111111111111111111111111111111111111111111111111111111111111111111111
1111111111111111111111111WWWWWWWWWWWWWWWWWWWWWWWWWWWWWWWWWWWWWWWWWWWWWWWWWWWWWWWWWWWWWW11
111111111111111111111111W111111111111111111111111W11111111111111111111W1111111111111111W1
111111111111111WWWWWWWWW1112222222222222222111111W1W1111W111W11111111111111111W11111W111W
11111111111111W1111111111121111111WW1111111211111W111W111111111W11W11111111111111W111111W
1111111111111W11111111111211111111WW1111111211111W111111W11111111111W11W11111111111111W1W
1111111111111W11111111111211111111221111111211111W111111111W1111W11111111111W111111W1111W
1111111111111W1111111111121111111122111111121WWW1W11W11W11111111111111111111111111111111W
1111111111111W1111WWWWWW121111111122111111121W1W1W111111111111W11111W1111W1111111W11W111W
1111111111111W1111W1111W1211111111WW1111111211W111111111111111111W11111W111111W111111111W
1111111111111W1111W111111211111111WW111111121W1W1W11W111W11W1W111111111111111111111111W1W
1111111111111W1111W11111121111111122111111121WWW1W1111111111111111111W11111111111W111111W
1111111111111W1111W1111W1211111111221111111211111W1111W111W1111111W11111W111111111111111W
1111111111111W1111WWWWWW1211111111WW1111111211111W111111111111W11111111111111W111111W111W
1111111111111W11111111111211111111WW1111112111111W11W1111W111111W1111W1111111111W1111111W
1111111111111W11111111111122222222222222221111111W1111111111W11111W11111W11W1111111W1111W
1111111111111W11111111111111111111111111111111111W11111111111111111111111111111111111111W
11111111111111W111WWWWWWWWWWWWWWWWWWWWWWWWWWWWWWWWWWWWWWWWWWWWWWWWWWWWWWWWWWWWWWWWWWWWWWW
11111111111111W111W11111111111111111111111111111111W11111W111111111111111111111111111111W
11111111111111W111W11111111111111111111111111111111W11111W111111111111111111111111111111W
11111111111111W111W11111111111111111111111111111111W11111W1111111111111111WWWWWWWW111111W
11111111111111W111W11111111111111111111111111111111W11111W1111111111111111WWRRRRRR11WW11W
11111111111111W111W11111111111111111111111111111111WWWW11W1WWWWW111WWWWW111WRRWWWWWWWW11W
11111111111111W111W111111111111111W111111111111111111111111W11111111111W111WRRWCCCCCW111W
11111111111111W111W1111111111111111111111111111111111111111W11111111111W111WRRWCCCCCW111W
11111111111111W111W11111W111W111111111111111111111111111111W1RRRRRRRRR1W111WRRWCCCCCW111W
11111111111111W111W11111111111111111111111R1R1R111111111111W1R1R111R1R1W111WRRCCCCCCW111W
11111111111111W111W1111111111111W1111111R1111111R1111111111W1R1R111R1R1W111WRRCCCCCCW111W
11111111111111W111W1111111111111111111R222WWWWW111111111111W1R1R111R1R1W111WRRWCCCCCW111W
11111111111111W111W1111111W111111111R22222WRRRW11R111111111W1R1R111R1R1W11WWWWWWWWWWWW11W
11111111111111W111W11111111111111111222222WRRRW111111111111W1PPPPPPPPP1W11WW11111111WW11W
11111111111111W111W1111111111W11111R2WWWWWWWRWWWW1R11111111W1R1R111R1R1W1111111111111111W
11111111111111W111W111111111111111112WRWLLWRRRWWW1111111111W1R1R111R1R1W111111W111111111W
11111111111111W111W11111W1111111W11R2WRWWWWRRRWLW1R11111111W1R1R111R1R1W1111111111111111W
11111111111111W111W111111111111111122WRRRRRRRRWWW1111111111W1R1R111R1R1W1111111111111111W
11111111111111W111W111111111111W111R2WRRRRRRRRRRW11R1111111W1RRRRRRRRR1W111111111W11W111W
11111111111111W111W11111111W111111122WWWWRRRRRWWW1111111111W11111111111W1111111111111111W
11111111111111W111W1111111111111111R2WLLRCRRRRWLW111R111111W11111111111W11111111W1111111W
11111111111111W111W111111111111111122WLLWRRRRRWWW1111111111WWWWW111WWWWW1111111111111111W
11111111111111W111W1111111111111111R2WWWWWCCCWWWW1111R111111111111111111111111111111W111W
11111111111111W111W111111111111111122WCCCWCCCWCCW111111111111111111111111111111111111111W
11111111111111W111W111111111111111R22WCCCCCCCCCCW11111R1R1R1R111111111111111111111111111W
11111111111111W111W111111111111111222WCCCWCCCWCCW1111111111111R1R1R1R1R111111111W1111111W
11111111111111W111W11111111111111R2WWWWWWWCCCWWWWWWWWWWWWWWW111111111111R1111111111W1111W
11111111111111W111W1111111111111122WCCCCCCCCCCWCWRRRRRRRRRRRW1111RRR111111R1111111111111W
11111111111111W111W11111111111111R2*CCCCCCCCCCRC*RRRRRRRRRRRRR111RWR11111111R1111111W111W
11111111111111W111W1111111111111121WCCCCCCCCCCRCWRRRRRRRRRRRRRW11RRR11111111121111111111W
11111111111111W111W11111WW1111111R2WCCCWWWCCCCCC*RRRRRRRRRRRRRRWWWWWWWWWWWWW2R2111111111W
11111111111111W111W11111WW111111121*CCCWWWCCCCCWWRRRRRRRRRRRRRRWWLWWLWWWRRRW22211111W111W
11111111111111W111W11111111111111R2WCCCWWWCCCCCWWRRRRRRRRRRRRRWCRRRRRRRWRRRW2R2111111111W
11111111111111W111W1111111111111122WWWWWWWWWCCWWWWCCWWWRRRRRRRCCRRRRRLLWRRRW222111W11111W
11111111111111W111W11111111111111R2WCCCCCCCCCCCCWCCCCCWWWWWWWCCCWWWCCWWWRRRW2R2111111111W
11111111111111W111W1111111111111122WCCCCCCCCCCCCCCCCCCCCCCCCCCCCCCCCCCWWRRRW222111111111W
11111111111111W111W11111111111111R2*RRCCCCCCCWCCCCCCCCCCCCCCCCCCCCCCCCCWRRRW2R2111111111W
11111111111111W111W1111111111111122WWWRCCCCCWWWCWCCCCCWWWWWWWWCCWCCCCCC*RRRW222111111111W
11111111111111W111W1111111111111R22WWWRCCCCCWWWCWCCCCCCCCCWCCCCCWCCCCCCWRRRW2R2111111111W
11111111111111W111W11111111111R222L*RRCCCCCCCWCCWCCCCCCCCCWCCCCCWCCCCCWRRRRW222111111W11W
1111111111111W1111W1111111111122222WWCCCCCCCCCCCWCCCCCWCCCWCCCCCWCCCC*RRRRW22R2111111111W
WWWWWWWWWWWWW11111W11111111111R2WWWWWCCWWWWWWW*WWWWCCWWW*WWWW*WWWW*WWRRRRW2222211W111111W
W11111111111111111W1111111111122WRRWCCCCCCCWRRRRRRRRRRRRRRRRRRRRRRRRRRRRW22R221111111111W
W1W1111W11W11W1111W1111111111RRRRRRCCCCCCCC*RRRRRRRRRRRRRRRRRRRRRRRRRRRW222221111111W111W
W1W1111111W1111111W1111111111RRRRRRCCCCWWCCWRRRRRRRRRRRRRRRRRRRRRRRRRRW22R22111111111111W
W1W1111W11111W1111W1111111111222WRRW*CCWWCCWWWWWWWWRRWWWWWWWWWWWWWWWWW222221111W11111111W
W111111W11111W1111W11111111112R2WRRW*CWWWWCW2222222RR222222222222222222R2211111111111111W
W11111111111111111W1112221111222WRR*WCCCCCCW222122RRRR2R2R2R2R2R2R2R2R222111111111111111W
WWWWWWWW11W11W1111W112WW221112R2WRRWWWWWWWWW2222222RR22222222222222222221111W111111W1111W
WRRRRRRWW1W1111111W112WW22211222WWWWWW*W*WWW2222R21RR11111111111111W11111111111111111111W
WRWRRRRR*111111111W11222222112R222222222222222R2211RR11111111111111W111111111W1111111111W
WRWRRRRR*1111W1111W111221111R122R2R2R2R2R2R2R222111RR11111111111111W11111111111111111111W
WRWRRRRR*1W1111111W1111111R111122222222222222221111RR11111111111111W11111W11111111111111W
WRRRRRRWW1111W1111W11111R11111111111111111111111111RR11111111111111W11111111111111111111W
WWWWWWWW11111W1111W11111111111111111111111111111111RR11111111111111W1111111111W111111111W
W11111111111111111WWWW1R11WW11111111111111111111111RR11111111111111W11111111111111W11111W
W11W11W11W1111R111W11111111W11111111111111111111111RR11111111111111W11111111111111111111W
W11111W11111111111W111R1111W11W11111111111111111111RR11111111111111W1111111W111111111111W
W11111111WR11W1R11111111111W2WLW2222222222222222222RR22222222222221W11111111111W111W1111W
W11W11W111111W111R1R1R11111W22W22222222222222222222RR22222222222221W11111111111111111111W
W11W11W11WR1111111111111111W22222222222222222222222RR22222222222221W11111111111111111111W
W1111111111111111W11R111111WWWWWWWWWWWWWWWWWWWWWWWWRRWWWWWWWWWWWWWWWWWWWWWWWWWWWWWWWWWWWW
WWWWWWWWWWWWWWWWWW1111WWW111111111111111111111111111111111111111111W111111111111111111111
W1W1111W1111111WRRRRRRRRW11111111111111RRRRRRRRRRRRRRRRRR1111111111W111111111111111111111
W11111111111111WRRRRRRRRRRR111111111RRRRRRRRRRRRRRRRRRRRRR111111111W111111111111111111111
W1W11W1W11W11W1WRRRRRRRRRRRR1111111RRRRRRRRRRRRRRRRRRRRRRRRR1111111W111111111111111111111
W11111111111111WRRRRRRRRRRRRR11111RRRRRRRRRRRRRRRRRRRRRRRRRRR111111W111111111111111111111
W11WWWWWWWWW111WRRRRRRRRWRRRRR111RRRRRRRRRRRRRRRRRRRRRRRRRRRRR11111W111111111111111111111
W11W1W1W1W1W1W1WRRRRRRRRWRRRRRR1RRRRRRRR11111111111111111RRRRRR1111W111111111111111111111
W11WWWWWWWWW1111RRRRRRRRRRRRRRRRRRRRRR11111111111111111111RRRRRR111W111111111111111111111
WW11111111111111RRRRRRRRRRRRRRRRRRRR11111111111112222111111RRRRR111W111111111111111111111
W111111221111111RRRRRRRRRRRRRRRRRRR1111111111112221222211111RRRRR11W111111111111111111111
W11W112W2111111WRRRRRRRRWRRRRRRRRR111111111122222222212222111RRRR11W111111111111111111111
W11111221111111WRRRRRRRRWRRRRRRRRR1111111122222222222222222211RRRR1W111111111111111111111
W1W1111111111W1WRRRRRRRRRRRRRRRRRR1111111222122122122222222221RRRR1W111111111111111111111
W111WWWWW111111WRRRRRRRRRRRRRRRRRR1111112221222222222122212222RRRR1W111111111111111111111
W111W1W1W11W111WRRRRRRRRRRRRRRRRRRR1111122222222212221222222221RRR1W111111111111111111111
W1W1WWWWW111111WRRRRRRRRW11RRRRRRRR1111222222122222222222222222RRRRW111111111111111111111
W111111111W11W1WW111111WW111RRRRRRRR1O1222122221222122221222212RRRRW111111111111111111111
W1111111111111111111111111111RRRRRRR111212222222222222222222222RRRRW111111111111111111111
WWWWWWWWWWWWWWWWWWWWWWWWWWWWWWWWWWWWWWWWWWWWWWWWWWWWWWWWWWWWWWWWWWWW111111111111111111111
