Grassy,none,1,0
IIIIIIIIIIIIIIIIIIIIIIIIIIIIIIIIIIIIIIIIIIIIIIIIIIIIIIIIIIIIIIIIIIIIIIIIIIIIIIIIIIIIIIIIIIIIIIIIIIIIIIIIII
I11111WWWWWWWWWWWWWWWWWWWWWWWWWWWWWWWWWWWWWWWWWWWWWWWWWWWWWWWWWWWWWW1111111111111111111111111111111111111I
I11111WRRRWCCCCW**WCCC2WRCRCRCRCRWCCCCCCCCCCCCCW1111111111111111111W1111111111111111111111111111111111111I
I11111WRRRWCCCCW**WCCCCWCRCRCRCRCWC2CCCCRCCCC2CW111RRRRRR*RRRRRR111W1111111111111111111111111111111111111I
I11111WRRRW2CCCCCCCCCCCWRCRCRCRCR*CCCCCRRRCCCCCW111R11111*11111R111W1111111111111111111111111111111111111I
I11111WRRRWWWWWWCCWWWWWWCRCRCRCRCWCCCCRRRRRCCCCW111R11111*11111R111W1111111111111111111111111111111111111I
I11111WRRRWWRRRWCCW2CC2WRCRCRCRCRWCCCCCRRRCCCCCW111R11111*11111R111W1111111111111111111111111111111111111I
I11111WRRRWRRRRRCCWCCCCWWWWWWWWWWWC2CCCCRCCCC2CW111RRRRRR*RRRRRR111W1111111111111111111111111111111111111I
I11111WRRRWRWRRWCCCCCCCWRRRC1CRRRWCCCCCCCCCCCCCW1111111111111111111W1111111111111111111111111111111111111I
I11111WRRRWWWWWWCCWCCCCCRRRC1CRRRWWWWWWWCWWWWWWWWWWWWWWWWWRRRRRRRRRW1111111111111111111111111111111111111I
I11111WRRRWCCCCWCCWCCCCCRRRC1CRRRWWWWWRRRRRWWWWWW*******WWRRRRRRRRRW1111111111111111111111111111111111111I
I11111WRRRWCCCCCCCWCCCCWRRRC1CRRRWWWRRRRCRRRRWWWCRRRRRRRCWRRRRCRRRRW1111111111111111111111111111111111111I
I11111WRRRWCCCCWCCWCCCCWRRRC1CRRRWWRCRRRRRRRCRWWCRRRRRRRCWRRRC1CRRRW1111111111111111111111111111111111111I
I11111WRRRWCCCCW2CW2CC2WRRRC1CRRRWWRRRRRLRRRRRWWCCCCCCCCCWRRRC1CRRRW1111111111111111111111111111111111111I
I11111WRRRWWWWWWWWWWWWWWRRRRCRRRRWRRRRRLLLRRRRRWWWWWCWWWWWRRRC1CRRRW1111111111111111111111111111111111111I
I11111WRRRRRRRRRRRRRRRRRRRRRRRRRRRRRRRLL1LLRRRRRRRRRRRRRRRRRRC1CRRRW1111111111111111111111111111111111111I
I11111WRRRRRRRRRRRRRRRRRRRRRRRRRRRRCRLL111LLRCRRRRRRRRRRRRRRRC1CRRRW1111111111111111111111111111111111111I
I11111WRRRWWWWWWWWWWWWWWRRRRCRRRRRRRRRLL1LLRRRRRRRRRRRRRRRRRRC1CRRRW1111111111111111111111111111111111111I
I11111WRRRWCCCCCCCCCCCCWRRRC1CRRRWRRRRRLLLRRRRRWWWWWWWWWWWRRRC1CRRRW1111111111111111111111111111111111111I
I11111WRRRWCC1C1C111C1CWRRRC1CRRRWWRRRRRLRRRRRWWCCCCCCCCCWRRRC1CRRRW1111111111111111111111111111111111111I
I11111WRRRWCC1C1CC1CC1CWRRRC1CRRRWWRCRRRRRRRCRWWCCCCCCCCCWRRRC1CRRRW1111111111111111111111111111111111111I
I11111WRRRWCC111CC1CC1CWRRRC1CRRRWWWRRRRCRRRRWWWCCCCCCCCCWRRRC1CRRRW1111111111111111111111111111111111111I
I11111WRRRWCC1C1CC1CCCCCRRRC1CRRRWWWWWRRRRRWWWWWCCCCCCCCCWRRRC1CRRRW1111111111111111111111111111111111111I
I11111WRRRWCC1C1C111C1CWRRRC1CRRRWWWWWWRWWWWWWWWCCCCCCCCCWRRRC1CRRRW1111111111111111111111111111111111111I
I11111WRRRWCCCCCCCCCCCCWRRRC1CRRRW111LL11LLL111WCCCCCCCCCCRRRC1CRRRW1111111111111111111111111111111111111I
I11111WRRRWCCCCCCCCCCCCWRRRC1CRRRW1111LL1LLLL11WCCCCCCCCCCRRRC1CRRRW1111111111111111111111111111111111111I
I11111WWWWWWWWWWWWWWWWWWRRRC1CRRRW1111LL1111LL1WCCCCCCCCCWRRRC1CRRRW1111111111111111111111111111111111111I
I111111111111111111WRRRRRRRC1CRRRW111LLL1WWLLL1WCCCCCCCCCWRRRC1CRRRW1111111111111111111111111111111111111I
I111111111111111111WRRCCCCCC1CRRRW111LLW1L11111WCCCCCCCCCWRRRC1CRRRW1111111111111111111111111111111111111I
I111111111111111111WRRRCCCCCCCRRRW1111LLLLLLLLLWCCCCCCCCCWRRRC1CRRRW1111111111111111111111111111111111111I
I111111111111111111WWRRRRRRRRRRRRW11111LLLLL11LWCCCCCCCCCWRRRC1CRRRW1111111111111111111111111111111111111I
I1111111111111111111WWRRRRRRRRRRRWWWWWWWWWWWWWWWWWWWWWWWWWRRRRCRRRRW1111111111111111111111111111111111111I
I11111111111111111111WWRRRRRRRRRRRRRRRRRRRRRRRRRRRRRRRRRRRRRRRRRRRRW1111111111111111111111111111111111111I
I111111111111111111111WWRRRRRRRRRRRRRRRRRRRRRRRRRRRRRRRRRRRRRRRRRRRW1111111111111111111111111111111111111I
I1111111111111111111111WWWRRRRRRWWWWWWWWWWWWWWWWWWWWWWWWWWWWWWWWWWWW1111111111111111111111111111111111111I
I111111111111111111111111WWRRRRWW111111111111111111111111111111111111111111111111111111111111111111111111I
I1111111111111111111111111WRRRRW1111111111111111111111111111111111111111111111111111111111111111111111111I
I1111111111111111111111111WRRRRW1111111111111111111111111111111111111111111111111111111111111111111111111I
I1111111111111111111111111WRRRRW1111111111111111111111111111111111111111111111111111111111111111111111111I
I1111111111111111111111111WRRRRW1111111111111111111111111111111111111111111111111111111111111111111111111I
I1111111111111111111111111WRRRRW1111111111111111111111111111111111111111111111111111111111111111111111111I
I1111111111111111111111111WWRRRW1111111111111111111111111111111111111111111111111111111111111111111111111I
I11111111111111111111111111WWRRW111111111111111111111IIIIIIIIIIIIIIIIIIIIIIWWWWWWWWWWWWWWWWWWWWWWWWWWWWWWI
I111111111111111111111111111WWRW111111111111111111111I111111111111111111111W1111111111111111111111111111WI
I1111111111111111111111111111WRW111111111111111111111I111111111111111111111W1111222222222222222222222111WI
I111111111111111111111111111WWRWW11111WWWWWWWWWWWWWWWI111111111111111111111W111122222222222222222222RRR1WI
I1111111111111111111111111WWWRRRWWW11WW222222222222222211111111111111111111W111122111111111111111111RLR1WI
I1111111111111111111111111WRRR11RRW1WW2222222222222222222111111111111111111WWWW1221WWWWWWWWWWWWWWW11RRR1WI
I111111111111111111111111WW1111111WWW22222222222222222222211111111111111111W11112211111111W111111W111111WI
I111111111111111111111111WC11111122W2222WWWWWWWWWWWWWI222221111111111111111111112211111111W111111W111111WI
I111111111111111111111111WRC11112222222WW111111111111I122222222222222222222222222211111111W111111WWWWWWWWI
I111111111111111111111111WRRC112222WWWWW1111111111111I112222222222222222222222222211111111W111111W222222WI
I1111111111111111111111WWWCRRC2222WW11111111111111111I112222222222222222222222222211111111W111111W222222WI
I111111111111111111111WWRC*CRRC222W111111111111111111I122221111111111111111111112211111111W1122222222222WI
I11111111111111111111WWRRRCWRRRCWWW111111111111111111I122211222222222222221W1111222222222222222222222222WI
I11111111111111111111WRRCRWWWWWWW11111111111111111111I122212222222222222221W111122222222222222211W222222WI
I11111111111111111111WRCRRWW1111111111111111111111111I122212222222222222221W11111111221111W111111W222222WI
I11111111111111111111WRRRWW11111111111111111111111111I122212222222222222221W11111111221111WWWWWWWWWWWWWWWI
I11111111111111111111WRRWW111111111111111111111111111I122212222222222222221W11111111221111WRRRWRRRRWRRRRWI
I11111111111111111111WRRW1111111111111111111111111111I122212222222222222221W11111111221111WRRRWRRRRWRRRRWI
I11111111111111111111WRRW1111111111111111111111111111I122212222222222222221W11111111221111WRRRWRRRRWRRRRWI
I11111111111111111111WRRW1111111111111111111111111111I122212222222222222221W11111122222211WRRRWRRRRWRRRRWI
I11111111111111111111WRRW1111111111111111111111111111I122212222222222222221W11111222222221WWRWWWWRWWWRWWWI
I11111111111111111111WRRW1111111111111111111111111111I122212222222222222221W11111222RR2221WRRRRRRRRRRRRRWI
I11111111111111111111WRRW1111111111111111111111111111I1222122222222222**221W1111122RRRR221WRRRRRRRRRRRRRWI
I11111111111111111111WRRW1111111111111111111111111111I1222122222222222**221W1111122RRRR221WRRRWWWRWWWRWWWI
IWWWWWWWWWWWWWWWWWWWWWRRWWWWWWWWWWWWWWWWWWWWW11111111I122212222222222222221W11111222RR2222RRRRWRRRRWRRRRWI
IWCCCCCCCCCCCCCCCCCCCCRRCCCCCCCCCCCCCCCCCCCCW11111111I122212222222222222221W11111222222222RRRRWRRRRWRRRRWI
IWCRRRRRRRRRRRRRRRRRRRRRRRRRRRRRRRRRRRRRRRRCW11111111I122212222222222222221W11111122222211WRRRWRRRRWRRRRWI
IWCRCRRRCRRRCRRRCRRRCRCCRCRRRCRRRCRRRCRRRCRCW11111111I122212222222222222221WWWWWW111221111WRRRWRRRRWRRRRWI
IWCRRRRRRRRRRRRRRRRRRRRRRRRRRRRRRRRRRRRRRRRCW11111111I122212222222222222221WRRRRW111221111WWWWWWWWWWWWWWWI
IWCRRRCCCCCCCCCCCCCCCCRRCCCCCCCCCCCCCCCCRRRCW11111111I122212222222222222221WRRRRR2222211111111111WRRRRRRWI
IWCRRRCRRRRRRRRRRRRRRCRRCRRRRRRRRRRRRRRCRRRCW11111111I122212222222222222221WRRRRW1112211112222222RRRRRRRWI
IWCRCRCRRRRRRRRRRRRRRCRRCRRRRRRRRRRRRRRCRCRCW11111111I122212222222222222221WRRRRW1112211122211111WRRRRRRWI
IWCRRRCRRRRRRRRRRRRRRCRRCRRRRRRRRRRRRRRCRRRCW11111111I122211222222222222221WWWWWW1112222222111111WRRRRRRWI
IWCRRRCRRRWWWWWWWWWWWWRRWWWWWWWWWWWWRRRCRRRCW11111111I1222111111111111111111111111112222222111111WWWWWWWWI
IWCRRRCRRRWCCCCCCCCCCWRRWCCCCCCPCCLWRRRCRRRCW11111111I1222222222222222222222222222222211122211111WRRRRRRWI
IWCRCRCRRRWCCCCCCCCCCWRRWLLLLLLCLCLWRRRCRCRCW11111111I1122222222222222222222222222222211112222222RRRRRRRWI
IWCRRRCRRRWCCCCCCCCCCWRRWLCCCCLCLCLWRRRCRRRCW11111111I1111222222222222222111111111111111111111111WRRRRRRWI
IWCRRRCRRRWCCCCCCCCCCWRRWLLLLCLCLCLWRRRCRRRCW11111111I111111111111111111111W111111111111111111111WRRRRRRWI
IWCRRRCRRRWCCCCCCCWWWWRRWWWWLCLCLCLWRRRCRRRCW11111111I111111111111111111111WWWWWWWWWWWWWWWWWWWWWWWWWWWWWWI
IWCRCRCRRRWCCCCCCCWRRRRRRRRWLCLCLPCWRRRCRCRCW11111111I111111111111111111111111111111111111111111111111111I
IWCRRRCRRRWCCCCCCCCRRRRRRRRCCCLCLLLWRRRCRRRCW11111111I111111111111111111111111111111111111111111111111111I
IWCRRRCRRRWCCCCCCCWRRR1RRRRWLCLCPCLWRRRCRRRCW11111111I111111111111111111111111111111111111111111111111111I
IWCRRRCRRRWCCCCCCCWRRRRRRRRWLCLLLCLWRRRCRRRCW11111111I111111111111111111111111111111111111111111111111111I
IWCRCRCRRRWCCCCCCCWRRRRRRRRWLCCCLCLWRRRCRCRCW11111111I111111111111111111111111111111111111111111111111111I
IWCRRRCRRRWCCCCCCCWWWWWCWWWWLLLCLCLWRRRCRRRCW11111111I11111111111111111111111111111111111111111111W111111I
IWCRRRCRRRWCCCCCCWCCCCCCCCCWWWLCPCLWRRRCRRRCW11111111I1111111111111111111111111111111111111111111WWW11111I
IWCRRRCRRRWCCCCWWCCCCCCCCCCCCWLLLLLWRRRCRRRCW11111111I111111111111111111111111111111111111111111WW2WW1111I
IWCRCRCRRRWCCCCWWCCCCCCCCCCCCWWWLLLWRRRCRCRCW11111111I11111111111111111111111111111111111111111*RR22WW111I
IWCRRRCRRRWCCCWRRCCCCCCCCCCCCRRRRRRWRRRCRRRCW11111111I1111111111111111111111111111111111111111WR2RRRRWW11I
IWCRRRCRRRWWWWRRWCCCCCCCCCCCCWRRRRRWRRRCRRRCW11111111I111111111111111111111111111111111111111WWRRR22RRWW1I
IWCRRRCRRRWWWRRRW************WRRRRRWRRRCRRRCW11111111I11111111111111111111111111111111111111WWRR2RR22R2WWI
IWCRCRCRRRWWRRRRWWWWWWWWWWWWWWRRRRWWRRRCRCRCW11111111I111111111111111111111111111111111111111WWR22RRRRWW1I
IWCRRRCRRRWWWWWWWWWWWWWWWWWWWWWWWWWWRRRCRRRCW11111111I1111111111111111111111111111111111111111WWR2RR2WW11I
IWCRRRCRRRRRRRRRRRRRRRRRRRRRRRRRRRRRRRRCRRRCW11111111I11111111111111111111111111111111111111111WWWRWWW111I
IWCRRRCRRRRRRRRRRRRRRRRRRRRRRRRRRRRRRRRCRRRCW11111111I111111111111111111111111111111111111111111WWRWW1111I
IWCRCRCRRRRRRRRRRRRRRRRRRRRRRRRRRRRRRRRCRCRCW11111111I1111111111111111111111111111111111111111111WWW11111I
IWCRRRCCCCCCCCCCCCCCCCCCCCCCCCCCCCCCCCCCRRRCW11111111I11111111111111111111111111111111111111111111W111111I
IWCRRRRRRRRRRRRRRRRRRRRRRRRRRRRRRRRRRRRRRRRCW11111111I111111111111111111111111111111111111111111111111111I
IWCRCRRCRRRCRRRCRRRCRRRCRRRCRRRCRRRCRRRRRCRCW11111111I111111111111111111111111111111111111111111111111111I
IWCRRRRRRRRRRRRRRRRRRRRRRRRRRRRRRRRRRRRRRRRCW11111111I111111111111111111111111111111111111111111111111111I
IWCCCCCCCCCCCCCCCCCCCCCCCCCCCCCCCCCCCCCCCCCCW11111111I111111111111111111111111111111111111111111111111111I
IWWWWWWWWWWWWWWWWWWWWWWWWWWWWWWWWWWWWWWWWWWWW11111111I111111111111111111111111111111111111111111111111111I
IIIIIIIIIIIIIIIIIIIIIIIIIIIIIIIIIIIIIIIIIIIIIIIIIIIIIIIIIIIIIIIIIIIIIIIIIIIIIIIIIIIIIIIIIIIIIIIIIIIIIIIIII
